vjedr#	æ°´æ¡¶
vje%ljvna	æœ‰ç¤¼è²Œçš„
vjenjk	æ‰«å¸š
ankjeta	ç™»è®°è¡¨,å±¥å†è¡¨(æºè‡ªæ³•è¯­enquiry)
ataka	å†²é”‹,è¿›æ”»(attack)
atljetjka	ç«æŠ€è¿åŠ¨(athletic)
at@m	åŸå­(atom)
attjestat	(ä¸­å­¦)æ¯•ä¸šè¯ä¹¦
aerodrom	é£æœºåœº(aerodrome)
aeroport	èˆªç©ºæ¸¯,èˆªç©ºç«™(airport)
basnja	å¯“è¨€(æºäºå¤ä¿„è¯­)
ba$nja	å¡”æ¥¼(æºäºæ³¢å…°è¯­)
bditjel'na	è­¦æƒ•çš„(Ğ±Ğ´Ğ¸Ñ‚ĞµĞ»ÑŒĞ½Ñ‹Ğ¹)
-@st	å½¢å®¹è¯å˜æˆçš„åè¯æ€§è´¨åç¼€ï¼ˆ-anceï¼‰
bditjeln@st	è­¦æƒ•æ€§
bjel'j#	å†…è¡£(Ğ±ĞµĞ»ÑŒÑ‘)
bjenzjn	æ±½æ²¹(benzine)
bjerj#za	ç™½æ¡¦æ ‘(Ğ±ĞµÑ€Ñ‘Ğ·Ğ°)
-jm	ç¬¬ä¸€äººç§°åŠ¨è¯åç¼€
b#drina	ç²¾åŠ›å……æ²›çš„(Ğ±Ğ¾Ğ´Ñ€Ñ‹Ğ¹)
b#j	æˆ˜æ–—(Ğ±Ğ¾Ğ¹)
b#k	è‚‹éƒ¨,ä¾§é¢(Ğ±Ğ¾Ğºè¯æºåŒback)
boks	æ‹³å‡»(boxing)
b@l'$evjk	å¸ƒå°”ä»€ç»´å…‹(Ğ±Ğ¾Ğ»ÑŒÑˆĞµĞ²Ğ¸Ğº)
bomba	ç‚¸å¼¹ bomb
b@rjets	(ä¸ºæŸé¡¹äº‹ä¸šè€Œæ–—äº‰çš„)æ–—å£«
b#rt	èˆ¹èˆ·
b@rba	æ–—äº‰
b@s#na	èµ¤è„šçš„(Ğ±Ğ°ÑĞ¾Ğ¹)
brak	åºŸå“,ç‘•ç–µ
brjevn#	åŸæœ¨
brjgada	çªå‡»é˜Ÿ(brigade)æ—…
buljon	é«˜æ±¤(bouillon)
bur%uazja	å¸ƒå°”ä¹”äºš,èµ„äº§é˜¶çº§(bourgeoisie)
burna	æ±¹æ¶Œçš„,çŒ›çƒˆçš„(Ğ±ÑƒÑ€Ğ½Ñ‹Ğ¹)
burja	æš´é£é›¨,é£æš´(Ğ±ÑƒÑ€Ñ)
val's	åœ†èˆæ›²,åå°”å…¹(walts)
varjen'e	æœé…±,èœœé¥¯
varjona	ç…®çš„,ç‚–çš„,ç†¬çš„
jasim	ä¼‘æ¯ ä¼‘(ã‚„ã™)ã‚€
deptjer	æœ¬å­
deris	è¯¾,è®²åº§,æ¼”è®²,è®ºå› lecture,discourse
kitap	ä¹¦
kitaphana	ä¹¦åº—
lughet	è¯å…¸
+j$jo	è¯å…¸
mektep	å­¦æ ¡
san	æ•°å­—
s@n@p	ç­
sja	å¢¨æ°´
talaba	å¤§å­¦ç”Ÿ
aq	ç™½è‰²(é˜¿å…‹)
kyek	è“è‰²
q@z@l	çº¢è‰²(å…‹å­œå‹’)
rang	é¢œè‰²
aka	å“¥å“¥
ajle	å®¶
je	å®¶ã€€ã„ãˆ
ana	å¦ˆå¦ˆ
ata	ç»™ã€€ä¸(ã‚ãŸ)ãˆã‚‹
ekje	çˆ¶äº²
shjeshje	å§å§
ane	å§å§ã€€å§‰(ã‚ã­)
yj	éº»æœ¨
ang@z	ä¼ è¯´
a$	æ‰“å¼€
@d@s	å™¨çš¿
engimje	æ•…äº‹
@s	çƒŸ
cjragh	ç¯
dykjen	å•†åº—
%jebje	ç®­,ä½¿å¥”å‘ï¼Œä½¿æ€¥å¥”
%ol	è·¯
habar	æ–°é—»
hat	ä¿¡
kot	äº‹æƒ…ã€€äº‹(ã“ã¨)
kema	èˆ¹
kyezejnek	çœ¼é•œ
bazar	å¸‚åœº
yeljeng	æ­Œ
ita	æ­Œ(ã†ãŸ)
makale	ä½œæ–‡
qaghaz	çº¸
kamj	çº¸ã€€ç´™(ã‹ã¿)
qalam	ç¬”
qaranda$	é“…ç¬”
$apan	å¤§è¡£
tamaqa	é¦™çƒŸ
adam	äººç±»
aju	ç†Š
ajuan	åŠ¨ç‰©
alma	è‹¹æœ(é˜¿æ‹‰æœ¨å›¾)
at	é©¬
bajku$	çŒ«å¤´é¹°
bala	å­©å­
bas	å‹
bjel	è…°
ch#$qa	çŒª
bita	çŒª è±š(ã¶ãŸ)
ejel	å¥³äºº
gyl	èŠ±
%@lan	è›‡
mjr	ä¸–ç•Œ
arjest	å·ç›—(arrest)
-na	åè¯ã€åŠ¨è¯æˆ–è¯å¹²çš„å½¢å®¹è¯åŒ–åç¼€
bljest	å‘å…‰(Ğ±Ğ»ĞµÑÑ‚ĞµÑ‚ÑŒ/Ğ±Ğ»ĞµÑĞ½ÑƒÑ‚ÑŒ) + â€¦le ä»¥â€¦é—ªäº®
b#lt	é—²æ‰¯,ä¹±è¯´(Ğ±Ğ¾Ğ»Ñ‚Ğ°Ñ‚ÑŒ)
bri	åˆ®,å‰ƒ(Ğ±Ñ€Ğ¸Ñ‚ÑŒ)
varj	ç…®(Ğ²Ğ°Ñ€Ğ¸Ñ‚ÑŒ)
%yrjek	å¿ƒè„
jerkjek	ç”·äºº
jet	è‚‰ et 
jt	ç‹—ğŸ¶
kisi	äºº
hit	äººã€€ã²ã¨
hacj	èœ‚ ã¯ã¡ Ğ¿Ñ‡ĞµĞ»Ğ°
kyez	çœ¼ç›
ku$	é¸Ÿ
pil	å¤§è±¡
cj	åœ°,åœ°è¡¨,åœ°é¢ã€€ã¡
te	æ‰‹ã€€ã¦
qoz@	ç¾Šç¾”
syez	word,å•è¯,å­—
ajt	è¯´,è®²è¿°,æåˆ°talk
al	æ‹¿
anlo	ç†è§£ n.
likaj	ç†è§£ã‚Šã‹ã„
apar	æ‹¿å»
baj@	å˜å¯Œ
bar	å»
bjer	ç»™
bol	æ˜¯
olinga	å¤©
b&l	åˆ†å¼€
dje	è¯´say
djemal	ä¼‘æ¯
kaz	é£ é¢¨(ã‹ãœ)
t#ng	å†»
ekjel	æ‹¿æ¥
%asa	æ´»
%at	èºº
%az	å¤å¤© åœŸï¼šyaz
%je	åƒ
%u	æ´—
%yr	èµ°
i$	å– iÃ§
jesti	å¬è§ hear
kir	è¿›å…¥ï¼ŒåœŸ: gir
kj	ç©¿
kjel	æ¥
kjet	ç¦»å¼€
kyer	çœ‹è§see åœŸï¼šgÃ¶r
kyj	ç‡ƒçƒ§
kyt	ç­‰
osta	æŠ“
yel	æ­»
yet	ç»è¿‡
#jmala	é›•
#jla	æƒ³ æ€è€ƒ think
#jna	ç©
#k@	è¯»,å­¦
#k@t	æ•™
#t@r	å
kael	è¿”å› å¸°(ã‹ãˆ)ã‚‹
q@l	åš
q#j	æ”¾
sat	ä¹°
syj	çˆ±
ai	çˆ± ã‚ã„
$@gh	å‡ºç‰ˆ
unut	å¿˜è®°
yr	å å«
erjnje	å½“ç„¶
ham	ä¹Ÿ
moq	ä¹Ÿ ã‚‚
hazir	ç°åœ¨
jmaq	ç°åœ¨ ä»Š(ã„ã¾)
njetame	ä¸ºä»€ä¹ˆ
nje$je	å¤šå°‘,å‡ ä¸ª
kajda	åœ¨å“ª
kalaj	æ€æ ·
ka$an	ä½•æ—¶
s#laj	è¿™æ ·
jana	åˆä¸€æ¬¡ again yine
axita	æ˜æ—¥(ã‚ã—ãŸ)
bi@l	ä»Šå¹´
bor@n	ä»å‰
bukyn	ä»Šå¤©
%ej	åª
asana	ç®€å•
azna	å°‘
bajna	å¯Œçš„
eng	æœ€
erna	æ¯ä¸€ä¸ª
esjemna	æ¼‚äº®çš„
gyzel	æ¼‚äº®
jestina	æ—§çš„
%ana	æ–°çš„
jojna	å¥½çš„
%asna	å¹´è½»çš„
jaki$iklina	å¸…,è‹±ä¿Šçš„
jegdjena	å¹´é•¿çš„
kerina	è€,å¤è€çš„
sjkna	æœ‰ç—…çš„
kyepna	è®¸å¤š
mosmosna	è½¯å›Šå›Šçš„
mutluna	é«˜å…´çš„
-rakna	æ›´
sauna	å¥åº·çš„
sami	å†·,å¯’å†·,å†·æ°” å¯’(ã•ã‚€)ã•
uzuna	é•¿
katana	å¤§
anau	é‚£ä¸ª
kim	è°
nje	ä»€ä¹ˆ
yez	è‡ªå·±
u	å¥¹ä»–å®ƒ,é‚£
aj	æœˆäº®
altin	é»„é‡‘(é˜¿å°”æ³°)
asman	å¤©,å¤©ç©º
aua	ç©ºæ°”
dengiz	å¤§æµ·
imj	æµ·(ã†ã¿)
dynja	ä¸–ç•Œ
mjlaj	æœªæ¥ ã¿ã‚‰ã„
eljem	å®‡å®™
gauhar	å®çŸ³
%jer	å¤§åœ°ï¼Œåœ°çƒ
julduz	æ˜Ÿæ˜Ÿ
hoxj	æ˜Ÿ(ã»ã—)
kyel	æ¹–
kyektjen	æ˜¥å¤©
hali	æ˜¥(ã¯ã‚‹)
kyl	ç°
haj	ç°(ã¯ã„)
muz	å†°
#rman	æ£®æ— åœŸï¼šorman
mori	æ£®(ã‚‚ã‚Š)
#t	ç«
su	æ°´
tabjet	è‡ªç„¶
tas	çŸ³å¤´
tau	å±±(å¡”æ ¼)
tjemir	é“(å¸–æœ¨å„¿)
yn	å£°éŸ³
hafta	æ˜ŸæœŸ
kyn	ç™½å¤©,å¤ªé˜³
doj	å¤©day
hj	æ—¥(ã²) ä»…æŒ‡å¤ªé˜³ ä¸å¯æŒ‡æ—¥æœŸ
saghat	é’Ÿè¡¨
tang	æ—©ä¸Š
tyn	å¤œ
ekim	å¸‚é•¿
d#s	æœ‹å‹
ghal@m	ç§‘å­¦å®¶
kadir	å¹²éƒ¨ ĞºĞ°Ğ´Ñ€Ñ‹
qaharman	è‹±é›„
q#%aj@n	ä¸»äºº
h#st	ä¸»äºº
ve	å’Œ
tagh@	ä¾ç„¶
alla	å®‰æ‹‰,çœŸä¸»,èƒ¡å¤§
asas	åŸºç¡€
baht	å¹¸ç¦
eurje	éº»çƒ¦
%al@q	äººæ°‘
%an	ç”Ÿå‘½
%as	å¹´é¾„
ymit	hopeå¸Œæœ›
jes	è®°å¿†
kyne	ç½ª
muhabbat	çˆ±æƒ…
oj	æ€æƒ³,idea
tarjh	å†å² åœŸï¼štarih
tengri	ä¸Šå¸,è…¾æ ¼é‡Œ
zaman	æ—¶ä»£
zang	æ³•å¾‹
tenenja	ä¸œæ–¹
cjenja	è¥¿æ–¹
tontasja	å—æ–¹
soghuknja	åŒ—æ–¹
cjkasu	é›ª
tasteno	å°é˜¶
#rmanka	æ ‘
gylko	ç§å­
kamjna	ç‰‡çŠ¶çš„
$a	å¶å­
cjkada	é‹å­
cjka	ç²‰
cjkade	è¸©
rj	æ²³
fu	è¡£æœ
cjef	è£¤å­
mjlet 	æ°‘æ—
cjraghlong	ç¯ç¬¼
sjenka	ç»³å­
tascj	åœ°æ¿
muzebj	æ£å­,æ£’å­
#jmalao	é›•åƒ
kyek@z@l 	ç´«è‰²
sjlkara	è­¦å¯Ÿ
yetmuto	é—¨
d#mkyez	çª—
kinj	å›½(ãã«),åœ°æ–¹,åŒºåŸŸ,å›½å®¶
cje	è½ä¸‹,ä¸‹è½
tosj	å¹´ ã¨ã—
ten	åœ¨ä¸Šé¢,ä¸Š,å¤©
tene	ä¸Šå‡,å‡èµ·
toko	åºŠ bed
ym	æ¢¦,æ¢¦æƒ³ å¤¢(ã‚†ã‚)
hjr#	è‹±é›„
taj	æˆ‘ ç¬¬ä¸€äººç§°
kjn	ä½  ç¬¬äºŒäººç§°
hebj	è›‡ã€€ã¸ã³
mu-	åŠ¨è¯å¦å®šå‰ç¼€
-e	åè¯ã€è¯å¹²çš„åŠ¨è¯åŒ–åç¼€
sotona	å¤–é¢çš„,ä¹‹å¤–çš„ å¤–(ãã¨)
leje	è¶´,é ,ä¾,å€š lay
sob	æ—è¾¹,èº«è¾¹ å´(ãã°) å˜å®¾æ ¼è¿˜åŸè¯å°¾å³sobam
kljana	æ¸…æ¥š,æ¸…æ™°,æ¸…æ¾ˆ,é€æ˜ clear
kjona	æ´å‡€,å¹²å‡€,çº¯æ´ æ¸…(ãã‚ˆ)ã„
kjmocj	å¿ƒæƒ…,æƒ…ç»ª,æ„Ÿå— æ°—æŒ(ãã‚‚)ã¡
#jmalaoe	åƒ,å¥½åƒ,ç±»ä¼¼ å•è¯"é›•åƒ#jmalao"çš„åŠ¨è¯åŒ– like
-o	åŠ¨è¯çš„åè¯åŒ–åç¼€åŠç°åœ¨åˆ†è¯(åŠ¨åè¯),å˜-eä¸º-o
-a	åŠ¨è¯çš„å°†æ¥æ—¶,å³å˜-eä¸º-a
-u	åŠ¨è¯çš„è¿‡å»æ—¶,å³å˜-eä¸º-u æˆ–åè¯çš„é—´æ¥å®¾æ ¼
jn	çš„
-jz	ç¬¬ä¸€äººç§°å¤æ•°åŠ¨è¯åç¼€
xjzika	å®‰é™,å¯‚é™,é™è°§ é™(ã—ãš)ã‹
-m	åè¯çš„ç›´æ¥å®¾æ ¼ ä¹Ÿå¯ä½œ-ma
-q	åè¯åŠ¨è¯æˆ–å½¢å®¹è¯ç­‰è¯å¹²çš„å‰¯è¯åŒ–åç¼€
-mek	åŠ¨è¯ä¸å®šå¼
s@u	è¿™ä¹ˆ,å¾ˆ so
bu	è¿™,è¿™ä¸ª
ja	å’Œ
hjlo	å®½é˜”,å¹¿é˜”,å®å¤§ åºƒ(ã²ã‚)
hjle	å¼€æ‹“,æ‰©å±•,æ‰©å¼  hjloçš„åŠ¨è¯å½¢å¼
fjle	æ„Ÿå—åˆ°,æ„Ÿè§‰åˆ° feel
ojoge	æ¸¸æ³³ æ³³(ãŠã‚ˆ)ã
-j	åè¯åç¼€,åœ¨â€¦å†…,åœ¨â€¦ä¸­.jç»“å°¾åˆ™ç”¨nj
kilo	é»‘ é»’(ãã‚)
sakila	æ¨±èŠ±ğŸŒ¸
-ba	åŠ¨è¯å‡å®šå¼ ã° åæ¬¡åç¼€ â€¦åœº
t#	æ¡ƒ,æ¡ƒå­,æ¡ƒæ ‘
yu	çƒ­æ°´ æ¹¯(ã‚†)
ymj	å¼“,å¼“å½¢ç‰© ã‚†ã¿
ymja	æ­¦å™¨ å¼“çŸ¢(ã‚†ã¿ã‚„)
tynasman	å¤œç©º
&	å­—æ¯,å‘éŸ³Ã¸
c	å­—æ¯,å‘éŸ³Ñ‡
x	å­—æ¯,å‘éŸ³Ñ‰
%	å­—æ¯,å‘éŸ³Ğ¶
$	å­—æ¯,å‘éŸ³Êƒ
+	å­—æ¯,å‘éŸ³ji(æ‹¼éŸ³)
=	å­—æ¯,å‘éŸ³ÑŒ
ishana	åŠå…¬å®¤
caj	èŒ¶(Ñ‡Ğ°Ğ¹)
cajhana	èŒ¶é¦†ï¼ˆÑ‡Ğ°Ğ¹Ñ…Ğ°Ğ½Ğ°ï¼‰
jol	ä» from ã‚ˆã‚Š
-dan	åè¯åç¼€ ä»ï¼ŒåŠ¨è¯æ„è¯åç¼€
-da	åè¯åç¼€ åœ¨
-le	åè¯åç¼€ ç”¨
-he	åè¯åç¼€ å»å‘,ä¹Ÿå¯ç›´æ¥ä½œåŠ¨è¯è¡¨å»æŸåœ° ã¸
po-	åŠ¨è¯ å®Œæˆä½“,è¿›è¡Œäº†ä¸€ä¼š
fika	æ·±,æ·±å¤„ æ·±(ãµã‹)ã•
k&p&r&k	è´è¶
are	å­˜åœ¨,åœ¨,æœ‰ ã‚ã‚‹
anka	çœ¼ç›
sue	çˆ±,çˆ±æƒœ,çˆ±æŠ¤ åŠ¨è¯
euje	å–œæ¬¢ åŠ¨è¯
bajhuaje	æ€å¿µ
hangbange	é™ªä¼´
falje	ç”Ÿæ°”,å‘æ€’
menlj	ç¾,æ¼‚äº®,ç¾ä¸½
ajjn	èŠ±
knu$	å¼“ç®­
valj$	é›¨
fana	æ¯ç­
kjongjq	å› ä¸º
dekj	èƒ½,èƒ½å¤Ÿ able
hjtsizen	å¿…ç„¶(ã²ã¤ãœã‚“)
konfljkto	å†²çª conflict
yukyu	æ‚ ä¹…(ã‚†ã†ãã‚…ã†)
@dvajs	å»ºè®®,æ„è§ advice
metibo	ç­äº¡ æ»…äº¡(ã‚ã¤ã¼ã†)
kamo	â€¦ä¹Ÿè¯´ä¸å®š ã‹ã‚‚ã—ã‚Œãªã„ç•¥
lo+jk	é€»è¾‘ logic
kae	è§£,è§£å¼€,è§£å†³ ã‹ã„
-eo	è¡¨å’å¹è¯ç¼€
rum	æˆ¿é—´,å±‹å­,æˆ¿å±‹ room
aremuareq	ç–‘é—®è¯ æœ‰æ²¡æœ‰
nikimolj	æ¸©æš–,æ¸©çƒ­ æ¸©(ã¬ã)ã‚‚ã‚Š
hate	ç»ˆç‚¹,å°½å¤´,ç»ˆç»“ æœ(ã¯)ã¦
todke	åˆ°è¾¾ arrive å±Š(ã¨ã©)ã
lamj	å…‰,å…‰æ˜,å…‰æ ‘
hejua	å’Œå¹³ å¹³å’Œ(ã¸ã„ã‚)
nar	â€¦çš„è¯ ãªã‚‰
ga	ä½†æ˜¯ ãŒ å¥ä¸­è¡¨è½¬æŠ˜,ç”¨åœ¨é€—å·å
kodoki	å­¤ç‹¬(ã“ã©ã)
est	æ˜¯ beåŠ¨è¯ æ—¶æ€å˜é¦–e ç‰¹æ®Š:etsjn(ç¬¬äºŒäººç§°å•æ•°)
zonsq	æ€»æ˜¯ always
uang	æ‘‡æ™ƒ,æ‘‡åŠ¨
xippo	å°¾å·´ å°»å°¾(ã—ã£ã½)
demq	ä½†æ˜¯ ç”¨åœ¨å¥é¦–
hejbon	å¹³å‡¡(ã¸ã„ã¼ã‚“)
yosq	è¦æ˜¯,å¦‚æœ
mj	æˆ‘è‡ªå·±(ä¸å¯ç”¨äºå…¶ä»–äººç§°åèº«)
yuze	ä½¿ç”¨ use
paua	åŠ›é‡ power
tek	ç§‘å­¦,ç§‘æŠ€ technology
litna	å°çš„
jrese	æ¸…é™¤,æ“¦é™¤,æŠ¹æ¶ˆ erase
zenbi	å…¨éƒ¨(ãœã‚“ã¶)
mono	ç‰©å“,äº‹ç‰© ç‰©(ã‚‚ã®)
nj	of
so$o	ç¤¾ä¼š social
dake	åªæœ‰ ã ã‘ åªç”¨åœ¨ä¿®é¥°ç‰©å
hitgomj	äººç¾¤ äººæ··(ã²ã¨ã”)ã¿
jamj	é»‘æš— é—‡(ã‚„ã¿)
kjken	å±é™© å±é™º(ãã‘ã‚“)
nare	æˆä¸º ãªã‚‹
t#xjkj	ç²‰è‰²,æ·¡çº¢è‰²,æ¡ƒè‰² ã¨ã†ã—ã
-xjkj	é¢œè‰²åç¼€ â€¦è‰² ã—ã
ao	é’è‰² ã‚ãŠ
ixj	ç‰›ğŸ® ã†ã—
hjtsi+j	ç¾ŠğŸ‘(ã²ã¤ã˜)
tola	è™(ã¨ã‚‰)ğŸ¯
isagj	å…”(ã†ã•ã)ğŸ°
nezimj	é¼ (ã­ãšã¿)ğŸ­
sake	é…’(ã•ã‘)
sixj	å¯¿å¸ ã™ã—
ima	ç¾å‘³(ä½³è‚´),é²œç¾ æ—¨(ã†ã¾)ã„
long	é¾™ğŸ‰
kuat	åœ£,ç¥åœ£ (ç”±æ—§nisiå­—æ¯è±¡å½¢"åœ£"å­—å¾—éŸ³)
sej	åŸå›  åªç”¨åœ¨jnå è¡¨æ¶ˆæä¹‰ ã›ã„
zej	æµªè´¹,å¥¢ä¾ˆ è´…(ãœã„)
maljna	è¦†ç›†å­ Ğ¼Ğ°Ğ»Ğ¸Ğ½Ğ°
lolipop	æ£’æ£’ç³–ğŸ­ lollipop
f#	å˜(å‘æ¶ˆææ–¹å‘) fall
kosq	æ‰,æ‰æ˜¯ ã“ã ç”¨åœ¨ä¸»ä½“å
elaj	ä¼Ÿå¤§,å“è¶Š,å‰å®³ å‰(ãˆã‚‰)ã„
kaolo	é¦™æ°”,é¦™å‘³ é¦™(ã‹ãŠ)ã‚Š
njoj	æ°”å‘³ åŒ‚(ã«ãŠ)ã„
a+j	(é£Ÿç‰©çš„)å‘³é“ å‘³(ã‚ã˜)
sprede	æ‰©æ•£,ä¼ æ’­ spread
ali	æŸ,æŸä¸ª æˆ–(ã‚)ã‚‹
hajaq	å¿«ç‚¹,æ—©ç‚¹ æ—©(ã¯ã‚„)ã
hajana	å¿«é€Ÿçš„ æ—©çš„ æ—©(ã¯ã‚„)ã„
cjxi	æ°¸è¿œ ä¸€ç›´
sahpjt	å‚»ç“œ ç¬¨è›‹ ç™½ç—´
gune	æ»š æ»šåŠ¨ æ»šè¿‡ ç¢¾
gumj	å·¥ä¸š industry
mjko	å·«å¥³ ã¿ã“
podo	èµ°çš„è·¯ æ­¥è¡Œ
jhj	å±±å³° å±±é¡¶ (ç”±æ—§nisiå­—æ¯æ‹Ÿå±±å°–çŠ¶è€Œå¾—éŸ³)
kjla	é—ªäº® é—ªé—ªå‘å…‰ äº®æ™¶æ™¶ ãã‚‰ãã‚‰
+jkan	æ—¶é—´ æ™‚é–“(ã˜ã‹ã‚“)
-ja	åè¯åœ°ç‚¹åç¼€
akj	ç§‹(ã‚ã)
naxj	æ—  ç©º ç„¡(ãª)ã—
banka	é“¶è¡Œ bank 
xjka	é¹¿ ã—ã‹
xjma	å²› ã—ã¾ ğŸ
tjg@r	è€è™ğŸ¯Ñ‚Ğ¸Ğ³Ñ€
par	è’¸æ±½ Ğ¿Ğ°Ñ€
fakt	äº‹å® Ñ„Ğ°ĞºÑ‚
plan	è®¡åˆ’ Ğ¿Ğ»Ğ°Ğ½
cjerjepaha	ä¹Œé¾ŸÑ‡ĞµÑ€ĞµĞ¿Ğ°Ñ…Ğ°
neko	çŒ« ã­ã“ğŸ±
neke	æ‰è€é¼  çŒ«çš„åŠ¨è¯åŒ–
avtobus	å¤§å·´è½¦ï¼ˆĞ°Ğ²Ñ‚Ğ¾Ğ±ÑƒÑï¼‰auto+bus
ljsa	ç‹ç‹¸ğŸ¦Š Ğ»Ğ¸ÑĞ°
akula	é²¨é±¼Ğ°ĞºÑƒĞ»Ğ°ğŸ¦ˆ
gjnga	é“¶æ²³ ãã‚“ãŒğŸŒŒ
$ja	è½¦ è»Š(ã—ã‚ƒ)
#t$ja	ç«è½¦
bjen$ja	æ±½è½¦ğŸš— bjenzjn $ja
ljet	é£ï¼ˆĞ»ĞµÑ‚Ğ°Ñ‚ÑŒï¼‰
yezljeto	é£æœºâœˆï¸ï¼ˆyez-ljet-oï¼‰
nikikema	æŸ´æ²¹æœºèˆ¹
parkema	è½®èˆ¹ï¼Œæ±½èˆ¹
dauan	å±±å£ ï¼ˆè¾¾å‚ï¼‰
+ami	æ¸…çœŸå¯ºï¼ˆåœŸè€³å…¶è¯­camiï¼‰
kida	æ°´æœ æœç‰©(ãã ã‚‚ã®)
xjna	å“ç§,ç±»åˆ«,é—¨ç±»,ç§‘ç›® å“(ã—ãª)
ame	ç³– é£´(ã‚ã‚)
amana	ç”œçš„ ç”˜(ã‚ã¾)ã„
angjel	å¤©ä½¿ğŸ‘¼ Ğ°Ğ½Ğ³ĞµĞ»
tserk@v	æ•™å ‚â›ªï¸Ñ†ĞµÑ€ĞºĞ¾Ğ²ÑŒ
s@bor	å¤§æ•™å ‚â›ªï¸ÑĞ¾Ğ±Ğ¾Ñ€
hrjest	åå­—æ¶Ñ…Ñ€ĞµÑÑ‚
krjexjeno	æ´—ç¤¼ï¼ˆĞºÑ€ĞµÑ‰ĞµĞ½Ğ¸Ğµï¼‰
tenkrjexjeno	<å®—>å¤æ´»ï¼ˆten-krjexjenoï¼‰Ğ²Ğ¾ÑĞºÑ€ĞµÑĞµĞ½Ğ¸Ğµ
spas	æ•‘ ÑĞ¿Ğ°ÑÑ‚Ğ¸
spaseno	æ•‘èµï¼ˆÑĞ¿Ğ°ÑĞµĞ½Ğ¸Ğµï¼‰
prostj	åŸè°…ï¼ˆv.ï¼‰ Ğ¿Ñ€Ğ¾ÑÑ‚Ğ¸Ñ‚ÑŒ
proxjeno	å®½æ•ï¼Œèµ¦å… Ğ¿Ñ€Ğ¾Ñ‰ĞµĞ½Ğ¸Ğµ
@kjean	å¤§æ´‹Ğ¾ĞºĞµĞ°Ğ½
qurban	å¤å°”é‚¦èŠ‚
pasha	å¤æ´»èŠ‚ĞŸĞ°ÑÑ…Ğ°
r@zhdjestvo	åœ£è¯èŠ‚Ğ Ğ¾Ğ¶Ğ´ĞµÑÑ‚Ğ²Ğ¾
hrjstjanstvo	åŸºç£æ•™Ğ¥Ñ€Ğ¸ÑÑ‚Ğ¸Ğ°Ğ½ÑÑ‚Ğ²Ğ¾
hayat	äººç”Ÿï¼Œç”Ÿæ´»
%jraf	é•¿é¢ˆé¹¿Ğ¶Ğ¸Ñ€Ğ°Ñ„
zjebra	æ–‘é©¬
aslan	ç‹®å­ğŸ¦
zayats	å…”å­ğŸ°Ğ·Ğ°ÑÑ†
kent	åŸå¸‚
kjep@st	å ¡å’ï¼Œè¦å¡ĞºÑ€ĞµĞ¿Ğ¾ÑÑ‚ÑŒ
qadam	ï¼ˆè¿ˆå‡ºçš„ï¼‰æ­¥ï¼Œæ­¥æ•°
sljed	ç—•è¿¹ÑĞ»ĞµĞ´
jslam	ä¼Šæ–¯å…°æ•™ Islam
mjage	ç¤¼ç‰©,åœŸç‰¹äº§ ãŠåœŸç”£(ã¿ã‚„ã’)
njmotsi	è¡Œæ è·ç‰©(ã«ã‚‚ã¤)
yuuhj	å¤•é˜³ å¤•æ—¥ğŸŒ‡(ã‚†ã†ã²)
tasogale	å‚æ™š é»„æ˜(ãŸããŒã‚Œ)
doki	ä¸€
sou	äºŒ
imjtil	é³é±¼ï¼Œé¾™åˆ©é±¼ï¼ˆæµ·èˆŒå¤´ Ğ¼Ğ¾Ñ€ÑĞºĞ¾Ğ¹ ÑĞ·Ñ‹Ğºï¼‰
tala	é³•é±¼ é±ˆ(ãŸã‚‰)
hala	è…¹éƒ¨,è‚šå­ è…¹(ã¯ã‚‰)
yatala	èƒ¡ä¹±,éšä¾¿ çŸ¢é±ˆ(ã‚„ãŸã‚‰)
kala	è¾›è¾£,è¾£å‘³ è¾›(ã‹ã‚‰)ã„
bjl	çŸ¥é“
kasa	ä¼(ã‹ã•)â˜”
molokoxj	ä¸­å›½ å”åœŸ(ã‚‚ã‚ã“ã—)
-sjz	å½¢å®¹è¯å¦å®šåç¼€ï¼Œæ²¡æœ‰â€¦çš„
ynsjzna	æ— å£°çš„
za-	åŠ¨è¯å‰ç¼€ï¼Œå¼€å§‹â€¦
fimot	å±±éº“ éº“(ãµã‚‚ã¨)
siso	(è¡£æœ)ä¸‹æ‘†,(æ²³å·)ä¸‹æ¸¸,æœ«ç«¯ è£¾(ã™ã)
jyz	è„¸
tenda	åœ¨â€¦ä¸Š
tenhe	å‘ä¸Š
cjda	åœ¨â€¦ä¸‹
cjhe	å‘ä¸‹
um	æ™ºæ…§ ÑƒĞ¼
ymdan%yrna	ç–¯çš„ï¼ˆum-dan-%yr-naï¼‰ÑÑƒĞ¼Ğ°ÑÑˆĞµĞ´ÑˆĞ¸Ğ¹
dard	ç—›è‹¦
anar	çŸ³æ¦´
bilan	ä¸â€¦ä¸€èµ·ï¼ˆåç½®ä»‹è¯ï¼‰
jch	é‡Œé¢,å†…éƒ¨ n. 
jchda	åœ¨â€¦é‡Œ prep. 
$ahar	é•‡ï¼Œå¸‚é•‡( åœŸï¼šÅŸehir)
jchhe	æœé‡Œé¢
dep	ä»¥ä¾¿ï¼Œä¸ºäº†ï¼Œin order to ï¼ˆconj.ï¼‰v. + dep
jar	çˆ±äºº
resim	å›¾ç”»
kljuch	é’¥åŒ™ğŸ”‘ĞºĞ»ÑÑ‡
kljuchsyez	å…³é”®è¯ï¼ˆkljuch-syezï¼‰
-tsja	è¥¿æ–¹æºä½¿åŠ¨è¯å˜ä¸ºæŠ½è±¡åè¯åç¼€ï¼Œ-tion
ann@tatsja	è¯„æ³¨ï¼Œæ³¨é‡Šï¼ŒĞ°Ğ½Ğ½Ğ¾Ñ‚Ğ°Ñ†Ğ¸Ñ, annotation
kagj	é”ğŸ”’ éµ(ã‹ã)
tanj	å±±è°· è°·(ãŸã«)
kanj	èƒèŸ¹ èŸ¹ğŸ¦€(ã‹ã«)
uakj	è…‹ä¸‹,æ—è¾¹,å…¶æ¬¡,æ¬¡è¦æ–¹é¢ è„‡(ã‚ã)
kyepmjletna	å¤šæ°‘æ—çš„ï¼ˆkyep-mjllet-naï¼‰Ğ¼Ğ½Ğ¾Ğ³Ğ¾ÑÑ‚Ğ½Ğ¸Ñ‡ĞµÑĞºĞ¸Ğ¹
standart	æ ‡å‡† ÑÑ‚Ğ°Ğ½Ğ´Ğ°Ñ€Ñ‚ standard
standartna	æ ‡å‡†çš„
avto-	å‰ç¼€ï¼Œè‡ªåŠ¨çš„
avtonomna	è‡ªæ²»çš„ Ğ°Ğ²Ñ‚Ğ¾Ğ½Ğ¾Ğ¼Ğ½Ñ‹Ğ¹, autonomous
slajolcev	å¼•ç”¨ï¼Œæ´å¼•â€¦ ï¼ˆÑĞ¾ÑĞ»Ğ°Ñ‚ÑŒÑÑï¼‰æ¥smth-he
slajol	æ”¾é€ï¼Œæµæ”¾ï¼ˆsla-jol, ÑĞ¾ÑĞ»Ğ°Ñ‚ÑŒï¼‰æ¥smb-m 
prj-	åŠ¨è¯å‰ç¼€ï¼Œæ¥ä¸´ï¼Œè§¦ç¢°åˆ°
prjsla	å¯„æ¥ï¼Œæ´¾æ¥
zasla	å¯„å‡º
poslaka	åŒ…è£¹ï¼ˆpo-sla-kaï¼‰Ğ¿Ğ¾ÑÑ‹Ğ»ĞºĞ°
podojolna	å¼€å§‹çš„ï¼Œèµ·å§‹çš„ï¼ˆpodo-jol-naï¼‰Ğ¸ÑÑ…Ğ¾Ğ´Ğ½Ñ‹Ğ¹
podojol	å¼€å§‹v.
podojolka	èµ·ç‚¹
todko	ç»ˆç‚¹,åˆ°è¾¾çš„åœ°æ–¹
sakehana	é…’é¦†
aqsake	ç™½é…’
q@z@lsake	çº¢é…’ğŸ·
yzymsake	è‘¡è„é…’
tali	æœ¨æ¡¶ æ¨½(ãŸã‚‹)
kan	ç½å¤´,è®¡æ•°ç½è£…ç‰©çš„é‡è¯ ç¼¶ğŸ¥«(ã‹ã‚“)
kjki	èŠèŠ± èŠ(ãã)
tanpopo	è’²å…¬è‹± ãŸã‚“ã½ã½
sizi	é“ƒé“›ğŸ”” éˆ´(ã™ãš)
kazkema	æ°”çƒğŸˆ é£+èˆ¹ é¢¨èˆ¹(ãµã†ã›ã‚“)
houlen	è èœ è è–(ã»ã†ã‚Œã‚“)
ajzi	ä¿¡å·,æš—å· åˆå›³(ã‚ã„ãš)
senlo	é“è·¯,é“è½¨ğŸ›¤ ç·šè·¯(ã›ã‚“ã‚)
yet#jna	è¾“(Ğ¿Ñ€Ğ¾Ğ¸Ğ³Ñ€Ğ°Ñ‚ÑŒ) ~smb-u smth-m è¾“ç»™æŸäººæŸç‰©
vi#jna	èµ¢(Ğ²Ñ‹Ğ¸Ğ³Ñ€Ğ°Ñ‚ÑŒ) ~ smb-da smth-m åœ¨æŸäººé‚£é‡Œèµ¢
vi-	åŠ¨è¯å‰ç¼€ï¼Œè¡¨äº‹æƒ…æˆåŠŸï¼ˆĞ²Ñ‹-ï¼‰win
-made	åè¯åç¼€ åˆ°â€¦ è¾¾åˆ°â€¦
bjegjem#t	æ²³é©¬ Ğ±ĞµĞ³ĞµĞ¼Ğ¾Ñ‚
v@r#na	ä¹Œé¸¦ Ğ²Ğ¾Ñ€Ğ¾Ğ½Ğ°
gjekon	å£è™Ğ³ĞµĞºĞºĞ¾Ğ½
djn@zavir	æé¾™Ğ´Ğ¸Ğ½Ğ¾Ğ·Ğ°Ğ²Ñ€
rog	è§’
dokirog	ç‹¬è§’å…½
jozh	åˆºçŒ¬ğŸ¦” ï¼ˆå¸¦é¬ƒæ¯›çš„ï¼‰é©¬æ¡¶åˆ·
jguana	é¬£èœ¥Ğ¸Ğ³ÑƒĞ°Ğ½Ğ°
jetj	é›ªæ€ªĞ¹ĞµÑ‚Ğ¸
kr@k@dil	é³„é±¼ĞºÑ€Ğ¾ĞºĞ¾Ğ´Ğ¸Ğ» ï¼ˆcrocodileï¼‰
m#r%	æµ·è±¡Ğ¼Ğ¾Ñ€Ğ¶
hanarog	çŠ€ç‰›ï¼ˆé¼»+rogï¼‰
@bjezjana	çŒ´å­ğŸµğŸ’Ğ¾Ğ±ĞµĞ·ÑŒÑĞ½Ğ°
pjngvjn	ä¼é¹…ğŸ§Ğ¿Ğ¸Ğ½Ğ³Ğ²Ğ¸Ğ½ penguin
mjech	å‰‘ Ğ¼ĞµÑ‡
bal@qmjech	å‰‘é±¼
%olka	èœ—ç‰› ï¼ˆ%ol-kaï¼‰ÑƒĞ»Ğ¸Ñ‚ĞºĞ°
flamjngo	ç«çƒˆé¸Ÿ
hamjak	ä»“é¼ ğŸ¹ Ñ…Ğ¾Ğ¼ÑĞº
tsipljonok	é› Ñ†Ñ‹Ğ¿Ğ»Ñ‘Ğ½Ğ¾Ğº
$mjel	ç†Šèœ‚ ÑˆĞ¼ĞµĞ»ÑŒ
xuka	ç‹—é±¼ï¼Œä¹”å°”æ³°ï¼ŒÑ‰ÑƒĞºĞ°
emu	é¸¸é¹‹
jurok	ç‡• ÑÑ€Ğ¾Ğº
jaguar	ç¾æ´²è™ ( ÑĞ³ÑƒĞ°Ñ€) Jaguar
v#vk	ç‹¼ğŸºï¼ˆä¹Œå…‹å…°è¯­ï¼‰Ğ²Ğ¾Ğ²Ğº
tsap	å±±ç¾ŠÑ†Ğ°Ğ¿ï¼ˆä¹Œå…‹å…°è¯­ï¼‰
$akal	è±ºÑˆĞ°ĞºĞ°Ğ»
burjak	ç”œèœ(ä¹Œå…‹å…°è¯­Ğ±ÑƒÑ€ÑĞº) 
vjlka	å‰å­ï¼Œæ’å¤´ï¼Œæ’é”€Ğ²Ğ¸Ğ»ĞºĞ°
motakinj	ç¥–å›½
manga	æ¼«ç”» ã¾ã‚“ãŒ
ongak	éŸ³ä¹â™¬ éŸ³æ¥½(ãŠã‚“ãŒã)
koe	(äººè¯´çš„)è¯,(äººçš„)å£°éŸ³ å£°(ã“ãˆ)
onsej	ä¹¦é¢è¯­ è¯­éŸ³ éŸ³å£°(ãŠã‚“ã›ã„)
koj	é²¤é±¼ é¯‰(ã“ã„)
sljez	çœ¼æ³ªÑĞ»ĞµĞ·
ase	æ±— ã‚ã›
oxjka	å°ä¾¿,å°¿ ãŠã—ã£ã“
inka	å¤§ä¾¿,å±ğŸ’© ã†ã‚“ã“
%opa	å±è‚¡,è‡€éƒ¨ Ğ¶Ğ¾Ğ¿Ğ°
ide	èƒ³è†Š,å‰è‡‚ è…•(ã†ã§)
sine	å°è…¿ è„›(ã™ã­)
ka+e	å’¬,å•ƒ,è¯•ä¸€ä¸‹,å­¦ä¸€ç‚¹ é½§(ã‹ã˜)ã‚‹
%andoj	ç”Ÿæ—¥ğŸ‚
kyerdekjna	å¯è§†çš„ï¼Œå¯è§çš„ Ğ²Ğ¸Ğ·ÑƒĞ°Ğ»ÑŒĞ½Ñ‹Ğ¹ visual
dokika	å•å…ƒï¼Œå•ä½ unit, ĞµĞ´Ğ¸Ğ½Ğ¸Ñ†Ğ°
hjna	é›é¸Ÿ,é›é¸¡ (æ¥åœ¨åè¯å‰)å°(å·§) é››(ã²ãª)
%oljxxjomono	æ—…ä¼´ï¼ŒåŒè¡Œè€…ï¼Œå«æ˜Ÿ
k@rona	ç‹å† ï¼Œå† çŠ¶ç‰©ï¼Œæ—¥å†• ĞºĞ¾Ñ€Ğ¾Ğ½Ğ° corona
jxxjo	ä¸€èµ·,ä¸€å—,ä¸€æ ·,åŒè¡Œ ä¸€ç·’(ã„ã£ã—ã‚‡)
sigo	å‡ºè‰²,å‰å®³,äº†ä¸èµ· å‡„(ã™ã”)ã„
koua	å¯æ€•,éª‡äºº æ€–(ã“ã‚)ã„
nodo	å–‰å’™,å’½å–‰ å–‰(ã®ã©)
kaua	å¹²ç‡¥,(å£)æ¸´ ä¹¾(ã‹ã‚)ã
kauaj	å¯çˆ±,å°å·§ç²ç‘ ã‹ã‚ã„ã„
jadro	æ ¸ï¼Œæ ¸å¿ƒ ÑĞ´Ñ€Ğ¾
nola	é‡â€¦ é‡è‰¯(ã®ã‚‰)
nolaneko	é‡çŒ« é‡è‰¯çŒ«(ã®ã‚‰ã­ã“)
k@mjeta	å½—æ˜Ÿ comet ĞºĞ¾Ğ¼ĞµÑ‚Ğ°
hv#st	å°¾å·´ Ñ…Ğ²Ğ¾ÑÑ‚
hajaxj	æ ‘æ—,æ—ç«‹çš„äº‹ç‰© å’Œæ±‰å­—æ—ç”¨æ³•å…¨åŒ ã¯ã‚„ã—
mon	èŠ±çº¹,èŠ±æ ·,å¾½ç«  ç´‹(ã‚‚ã‚“)
mjsakj	æµ·å²¬,æµ·è§’ å²¬(ã¿ã•ã)
muaj	ä¸€æœˆ ç¦æœˆ(ã‚€ã¤ã)
kjsalagj	äºŒæœˆ å¦‚æœˆ(ãã•ã‚‰ã)
jajoj	ä¸‰æœˆ å¼¥ç”Ÿ(ã‚„ã‚ˆã„)
iaj	å››æœˆ å¯æœˆ(ã†ã¥ã)
saaj	äº”æœˆ çšæœˆ(ã•ã¤ã)
susjzaj	å…­æœˆ æ°´ç„¡æœˆ(ã¿ãªã¥ã)
fimjaj	ä¸ƒæœˆ æ–‡æœˆ(ãµã¿ã¥ã)
$aaj	å…«æœˆ è‘‰æœˆ(ã¯ã¥ã)
uzuaj	ä¹æœˆ é•·æœˆ(ãªãŒã¥ã)
kuatsjzaj	åæœˆ ç¥ç„¡æœˆ(ã‹ã¿ãªã¥ã)
muzka	éœœ
muzkaaj	åä¸€æœˆ éœœæœˆ(ã—ã‚‚ã¤ã)
xjuasi	åäºŒæœˆ å¸«èµ°(ã—ã‚ã™)
cjkasucje	é™é›ª
b#bir	æ²³ç‹¸ Ğ±Ğ¾Ğ±Ñ€
$apka	å¸½å­ ÑˆĞ°Ğ¿ĞºĞ° ä¿„ç»´åœŸçš†åŒ
vite	æ•‘å‡ºï¼Œæ‹¯æ•‘ï¼ˆvi-teï¼‰Ğ²Ñ‹Ñ€ÑƒÑ‡Ğ¸Ñ‚ÑŒ
berimjletna	å…¨æ°‘æ—çš„(beri-mjlet-na) Ğ²ÑĞµĞ½Ğ°Ñ€Ğ¾Ğ´Ğ½Ñ‹Ğ¹
-gaki 	å­¦ç§‘åç¼€ï¼ˆå­¦ï¼‰
cjljgaki	åœ°ç†å­¦Ğ³ĞµĞ¾Ğ³Ñ€Ğ°Ñ„Ğ¸Ñ
k@ntjnjent	å¤§é™† ĞºĞ¾Ğ½Ñ‚Ğ¸Ğ½ĞµĞ½Ñ‚ continent
-dekjna 	å½¢å®¹è¯åç¼€, æ˜“äº..çš„,å¯..çš„(-able -Ğ°Ğ±ĞµĞ»ÑŒĞ½Ñ‹Ğ¹)
-alna	å½¢å®¹è¯åç¼€ï¼Œä¸â€¦ç›¸å…³çš„ï¼ˆ-al, -Ğ°Ğ»ÑŒĞ½Ñ‹Ğ¹ï¼‰
-mono	åè¯åç¼€,ä»äº‹â€¦çš„äºº,å·¥å…·,ä¸œè¥¿
-jzm	åè¯åç¼€,å­¦è¯´,æ”¿æ²»æ´¾åˆ«,ä¸»ä¹‰ï¼ˆ-Ğ¸Ğ·Ğ¼, ismï¼‰
-ka	åè¯åç¼€ï¼ŒæŒ‡å°è¡¨çˆ±
-hana	åœºæ‰€åç¼€ï¼Œå®¤ï¼Œé¦†
-$@ 	æŒ‡äººåç¼€
-arena	å½¢å®¹è¯åç¼€,å…·æœ‰ï¼ˆç‰©å“ï¼‰çš„ï¼Œ-Ğ»Ğ¸Ğ²Ñ‹Ğ¹
-lena	è¥¿æ–¹å¤–æ¥è¯çš„å½¢å®¹è¯åç¼€ï¼Œç”¨äºâ€¦çš„-Ğ»ÑŒĞ½Ñ‹Ğ¹ï¼Œ-
pjerje-	å‰ç¼€ï¼Œè¡¨åå¤
-jxxjo	åç¼€ï¼Œè¡¨å…±åŒå…³ç³»
kinjka	ç‚¹ï¼ˆkinj-kaï¼‰
en	åœ†ï¼ˆå††ï¼‰
gobj	æˆˆå£
engkinjka	æç‚¹ï¼Œæåœ°ï¼Œç£æï¼ˆeng-kinj-kaï¼‰Ğ¿oĞ»ÑÑ, pole
soghukna	å†·çš„
soghuknjana	åŒ—æ–¹çš„
soghuknjana engkinjka	åŒ—æ ÑĞµĞ²ĞµÑ€Ğ½Ñ‹Ğ¹ Ğ¿Ğ¾Ğ»ÑÑ North Pole
soghuknjana engkinjkana en	åŒ—æåœˆ ÑĞµĞ²ĞµÑ€Ğ½Ñ‹Ğ¹ Ğ¿Ğ¾Ğ»ÑÑ€Ğ½Ñ‹Ğ¹ ĞºÑ€ÑƒĞ³ Artic Circ
atama	å¤´ é ­
atamakent	é¦–éƒ½ï¼ˆatama-kentï¼‰
hejna	å¹³çš„
hejnja	å¹³åŸ
$tat	ï¼ˆè¡Œæ”¿å•ä½ï¼‰å·ï¼Œé‚¦ ÑˆÑ‚Ğ°Ñ‚ state
ekj	ç«™ï¼Œé§…
yel$@	æ­»è€…ï¼ˆyel-$@ï¼‰
yelka	å¢“
yelkalar	å…¬å¢“
ha$j	æ¡¥
kouen	å…¬å›­
kjoki	è®°å¿†
kjokimono	çºªå¿µç¢‘
kjokie	è®°å¾—v. 
zakjokie	è®°ä½ï¼ˆza-ï¼‰
kjokitenhe	(æƒ³èµ· -ten-he)
kjokitenmade	æé†’ï¼Œä½¿æƒ³åˆ°
tomarjkyep	åœè½¦åœºï¼ˆæ³Šã¾ã‚Š kyep)
lava	å²©æµ† lava Ğ»Ğ°Ğ²Ğ°
tuca	ä¹Œäº‘  Ñ‚ÑƒÑ‡Ğ°
raduga	å½©è™¹ğŸŒˆÑ€Ğ°Ğ´ÑƒĞ³Ğ°
tuman	é›¾Ñ‚ÑƒĞ¼Ğ°Ğ½ fog
t#ngvalj$ 	å†»é›¨ ï¼ˆt#ng-valj$ï¼‰Ğ³Ğ¾Ğ»Ğ¾Ğ»Ñ‘Ğ´
tundra	å†»åŸï¼Œè‹”åŸï¼Œå†»åœŸå¸¦Ñ‚ÑƒĞ½Ğ´Ñ€Ğ°
naxjja	è’æ¼ ï¼ˆnaxj-jaï¼‰
savanna	çƒ­å¸¦è‰åŸ ÑĞ°Ğ²Ğ°Ğ½Ğ½Ğ° Savanna è¨ç“¦çº³
sub-	å‰ç¼€ï¼Œå‰¯çš„ï¼Œäºšçš„ sub- ÑÑƒĞ±-
gumjja	é‡å·¥å‚
grjb	è˜‘è‡ï¼ˆĞ³Ñ€Ğ¸Ğ±ï¼‰
k#rjen	æ ¹ĞºĞ¾Ñ€ĞµĞ½ÑŒ
roza	ç«ç‘°ğŸŒ¹
hjcjdamono	å‘æ—¥è‘µğŸŒ» Ğ¿Ğ¾Ğ´ÑĞ¾Ğ»Ğ½ĞµÑ‡Ğ½Ğ¸Ğº sunflower
ljlja	ç™¾åˆ lily Ğ»Ğ¸Ğ»Ğ¸Ñ
lola	éƒé‡‘é¦™ğŸŒ·Ñ‚ÑĞ»ÑŒĞ¿Ğ°Ğ½ tulip
klubnjka	è‰è“ğŸ“ĞºĞ»ÑƒĞ±Ğ½Ğ¸ĞºĞ°
#st	éº¦èŠ’ Ğ¾ÑÑ‚ÑŒ
kome	å¤§ç±³ ğŸš
mugj	å°éº¦ Ğ¿ÑˆĞµĞ½Ğ¸Ñ†Ğ° wheat
r#%	é»‘éº¦Ñ€Ğ¾Ğ¶ÑŒ rye
sorgo	é«˜ç²± sorghum ÑĞ¾Ñ€Ğ³Ğ¾
kukuruza	ç‰ç±³ğŸŒ½ ĞºÑƒĞºÑƒÑ€ÑƒĞ·Ğ°
tenka	é¡¶ç‚¹
jn%jr	æ— èŠ±æœ Ğ¸Ğ½Ğ¶Ğ¸Ñ€
dub	æ©¡æ ‘ Ğ´ÑƒĞ±
palma	æ£•æ¦ˆæ ‘ğŸŒ´palm Ğ¿Ğ°Ğ»ÑŒĞ¼Ğ°
maualj	è½¬
jel	äº‘æ‰æ ‘ï¼Œææ ‘ğŸ„ĞµĞ»ÑŒ
mjtsi	èœœğŸ¯
ka	èšŠå­ (èšŠï¼ŒĞºĞ¾Ğ¼Ğ°Ñ€, mosquito)
hae	è‹è‡ ï¼ˆã¯ãˆ Ğ¼ÑƒÑ…Ğ° flyï¼‰
semj	è‰ï¼ˆÑ†Ğ¸ĞºĞ°Ğ´Ğ° cicada ã›ã¿ï¼‰
haxjeljeon	å˜è‰²é¾™ Ñ…Ğ°Ğ¼ĞµĞ»ĞµĞ¾Ğ½ chameleon
osa	é»„èœ‚ Ğ¾ÑĞ° yellowjacket
pauk	èœ˜è››ğŸ•· Ğ¿Ğ°ÑƒĞº spider
tako	ç« é±¼ğŸ™ ãŸã“ Ğ¾ÑÑŒĞ¼Ğ¸Ğ½Ğ¾Ğ³
ljagu$ka	é’è›™ğŸ¸ Ğ»ÑĞ³ÑƒÑˆĞºĞ°
kama	é•°åˆ€ éŒ(ã‹ã¾)
kjle	åˆ‡å‰² åˆ‡(ã)ã‚‹
kamakjlo	è³è‚ ã‹ã¾ãã‚Š Ğ±Ğ¾Ğ³Ğ¾Ğ¼Ğ¾Ğ» Mantid
hamjeljeon	å˜è‰²é¾™Ñ…Ğ°Ğ¼ĞµĞ»ĞµĞ¾Ğ½ chameleon
u%	æ¸¸è›‡ğŸ ÑƒĞ¶
jaxjerjtsa	èœ¥èœ´ ÑÑ‰ĞµÑ€Ğ¸Ñ†Ğ° lizard
tamago	è›‹ï¼Œåµ ãŸã¾ã”
ajst	é¹³ Ğ°Ğ¸ÑÑ‚ stork
gus	é¹… goose Ğ³ÑƒÑÑŒ
jndjuk	ç«é¸¡ğŸ¦ƒĞ¸Ğ½Ğ´ÑĞº
cjraka	ç¯æ³¡ğŸ’¡
den	ç”µ é›»(ã§ã‚“)
tak	æ¡Œ,æ¡ˆ,å‡  å“(ãŸã)
dentak	è®¡ç®—å™¨ é›»å“(ã§ã‚“ãŸã)
den$ja	ç”µè½¦ğŸšƒ é›»è»Š(ã§ã‚“ã—ã‚ƒ)
nou	èƒ½é‡,èƒ½åŠ› èƒ½(ã®ã†)
dennou	ç”µèƒ½
jadroka	èŠ¯ç‰‡
-kj	åè¯åç¼€ â€¦æœº
jadrokakj	ç”µè„‘
@sjol	é©´ Ğ¾ÑÑ‘Ğ»
at@sjol	éª¡
an	æ ã‚ã‚“
denkj	ç”µæœº,ç”µå™¨
kasimj	éœ ã‹ã™ã¿
namj	æ³¢æµª,æ³¢æ¶›,éœ‡åŠ¨,æ³¢åŠ¨ æ³¢ğŸŒŠ(ãªã¿)
hjki	ä½(ã²ã)ã„
fuke	å¹,å–·,å†’ å¹(ãµ)ã
kisa	è‰ ãã•
tale	æ‚¬å‚,æ»´,ä¸‹å‚ å‚(ãŸ)ã‚Œã‚‹
no	éƒŠå¤–,é‡å¤– é‡(ã®)
uake	æ¶Œå‡º,å–·å‡º,æ¶Œç°,äº§ç”Ÿ æ¹§(ã‚)ã
e	æ±Ÿ ãˆ
suslae	æµæ·Œ su-sla
s-	å‰ç¼€ with å’Œ,åŒ
tam	å› ä¸º,ä¸ºäº†,(çš„)åŸå›  â€¦jn tam ç‚º(ãŸã‚)
u%e	å·²ç» ÑƒĞ¶Ğµ
posjenka	ç½‘ poslaka-sjenka
hatslae	é€šä¿¡,é€ä¿¡,å‘é€,è”ç³»,é€šçŸ¥ hat-sla
anle	ç†è§£ v.
anlukoe	ç†è®º,åŸç†,å­¦è¯´ anle-u-koe
matsilj	ç¥­å…¸,èŠ‚æ—¥ ã¾ã¤ã‚Š
halj	é’ˆ é‡(ã¯ã‚Š)
halje	æ‰,åˆº,ç©¿é€
sutalo	æ°´æ»´,æ°´ç 
kohj	å’–å•¡â˜• ã‚³ãƒ¼ãƒ’ãƒ¼
dorj	è¯ğŸ’Š
dorjhana	è¯åº—
yezvarj	æ°´å£¶ï¼ˆyez-varjï¼‰
zaljet	èµ·é£
ljethate	ç€é™†
baraban	é¼“Ğ±Ğ°Ñ€Ğ°Ğ±Ğ°Ğ½
kane	é’Ÿ é˜ğŸ””(ã‹ã­)
@sajjn	çƒŸèŠ±ğŸ†
taburjet	å‡³Ñ‚Ğ°Ğ±ÑƒÑ€ĞµÑ‚
a	å˜´ï¼Œå£
bus	ç  Ğ±ÑƒÑ
brov(lar)	çœ‰æ¯› Ğ±Ñ€Ğ¾Ğ²Ğ¸
aha	å¯¹ï¼Œæ˜¯ï¼Œyes, Ğ´Ğ°
aha ve	å†µä¸”ï¼Œè€Œä¸” Ğ´Ğ° Ğ¸ 
foto	ç…§ç‰‡
fotokj	ç›¸æœºğŸ“·
so$o$@na	å¥½äº¤é™…çš„ï¼Œå¤–å‘çš„
%asajxxjono	å®¿èˆ
gustna	æµ“å¯†çš„ï¼Œæµ“ç¨ çš„ Ğ³ÑƒÑÑ‚Ğ¾Ğ¹
maj	æ²¹
lob	é¢å¤´ Ğ»Ğ¾Ğ±
guba(lar)	å˜´å”‡ï¼ˆĞ³ÑƒĞ±Ñ‹ï¼‰
laska	çˆ±æŠš
t#nkna	ç»†çš„ Ñ‚Ğ¾Ğ½ĞºĞ¸Ğ¹
k@ljen@	è†ç›–ĞºĞ¾Ğ»ĞµĞ½Ğ¾
jchna	å†…éƒ¨çš„
jchdan	ä»å†…éƒ¨ï¼Œä»â€¦å†…éƒ¨
-mj	ç–‘é—®åç¼€ï¼Œå—
muu%emj	éš¾é“ï¼ˆĞ½ĞµÑƒĞ¶ĞµĞ»Ğ¸ï¼‰Mu-u%e-mj
ka+o	å®éªŒ,è¯•éªŒ,å°è¯•
kjzi	å»ºé€ ,å»ºè®¾,æ„ç­‘,å»ºç«‹,æ„æˆ ç¯‰(ããš)ã
kjzio	å»ºç­‘ç‰©,å¤§æ¥¼
zenbilena	é€šç”¨çš„,æ™®é€‚çš„
let	é˜Ÿåˆ—,ä¸²è¡Œ,åºåˆ—,æ’åˆ— åˆ—(ã‚Œã¤)
rjimj	æ±‡èš,æ±‡é›†,æ±‡æ€» rj-imj
den%ol	ç”µè·¯,ç”µçº¿
rjimjden%ol	æ€»çº¿ bus
zenbilena let rjimjden%ol	é€šç”¨ä¸²è¡Œæ€»çº¿ Universal Serial Bus
ZLR	USB
yuzo	ä½¿ç”¨ç‰©,è®¾å¤‡,å·¥å…·,ä»ªå™¨
jchmono	å†…å®¹,å†…å«ç‰©
hjlohat	é€šçŸ¥,å…¬å‘Š,å¹¿å‘Š
lavj	åŒ–å­¦ Lavoisier(æ‹‰ç“¦é”¡)
hvalj	ç§°èµï¼Œé¢‚æ‰¬ Ñ…Ğ²Ğ°Ğ»Ğ¸Ñ‚ÑŒ
s#vjest	è‰¯çŸ¥ï¼Œå¤©è‰¯ ÑĞ¾Ğ²ĞµÑÑ‚ÑŒ
cajmono	èŒ¶å£¶
cajka	èŒ¶æ¯
zhil@ne	æ”¯æ£±ï¼Œç«–èµ·ï¼Œç¿˜èµ·
pul@ne	æ‰‘æ£±ï¼Œä¸Šä¸‹æ‹æ‰“
g@l@ne	ææ¥ï¼Œæ…æ‹Œ
b#le	æ‹¨æ‹‰ï¼Œæ‰«ç°ã€æ¥å›è½»è½»æ‹æ‰“çš„åŠ¨ä½œ
pje	æ’‡ï¼Œæ‰”ï¼Œä¸¢å¼ƒ
sjngjl	å¦¹å¦¹
tambuq	å› æ­¤ï¼Œæ‰€ä»¥
gjgant	å·¨äººï¼Œå·¨ç‰©
atacevno	æ•°æ®ï¼ˆç»™å‡ºçš„ä¸œè¥¿ï¼‰
p#st	å²—ä½
gjem@r#j	ç—”ç–®
%ukj	æ´—è¡£æœº
denkyerno	ç”µè§†ğŸ“º
denyn	ç”µè¯â˜ï¸ï¼Œæ‰‹æœº
holm	å±±ä¸˜ï¼Œå±±å²—
sjel#	æ‘ÑĞµĞ»Ğ¾
macj	è¡—é“,åŸé•‡ ç”º(ã¾ã¡)
lavjst	åŒ–å­¦å®¶
-jncjï¼Œ-ncj	åºæ•°è¯åç¼€
dokincj	ç¬¬ä¸€
soujncj	ç¬¬äºŒ
tana	èº«ä½“
jelka	è‚©
jlhom	çµæ„Ÿ
syezana	å­—æ¯
syezanajxxjo	å­—æ¯è¡¨
yezjyztsja	ç‹¬ç‰¹æ€§ yes-juz-tsja ÑĞ²Ğ¾ĞµĞ¾Ğ±Ñ€Ğ°Ğ·Ğ¸Ğµ
mavzaljej	é™µå¢“ Ğ¼Ğ°Ğ²Ğ·Ğ¾Ğ»ĞµĞ¹
%urnal	æ‚å¿—
%urnaljstjka	æ–°é—»å­¦
posoue	é‡å¤ï¼Œå¤ä¹ v. po-sou-e
muyelna	ä¸æœ½çš„
suna	æ°´çš„ï¼Œæ°´ä¸Šçš„
hrjstos	åŸºç£ï¼Œæ•‘ä¸–ä¸»
jsus	è€¶ç¨£Ğ˜Ğ¸ÑÑƒÑ
auarum	ç©ºé—´ space room
p#ska	ä½ç½® post-ka
do	åº¦ åè¯åç¼€,ä¸€ç§åº¦é‡å•ä½
rogdo	è§’åº¦
rodopka	ç›¸ä½ phase ä¿¡å·æ³¢å½¢å‘¨æœŸå˜åŒ–çš„åº¦é‡ rogdo-p#ska
enka	ç²’å­
namjenka	é‡å­
lamjenka	å…‰å­,å…‰é‡å­
bosonka	ç»è‰²å­ ä¸éµå®ˆæ³¡åˆ©ä¸ç›¸å®¹åŸç†
fermjonka	è´¹ç±³å­ è‡ªæ—‹ä¸ºåŠå¥‡æ•°(1/2,3/2â€¦)
itsi	åå°„,æ˜ å°„,åæ˜  æ˜ (ã†ã¤)ã™
itsimono	å‡½æ•°
namjitsimono	æ³¢å‡½æ•°
han-	å‰ç¼€ åâ€¦ anti-
hanitsimono	åå‡½æ•°
si	é†‹ é…¢(ã™)
cjoko	å·§å…‹åŠ›
cjokoxjkj	å·§å…‹åŠ›è‰²,æ£•è‰²
cjokomaj	é…±æ²¹
banana	é¦™è•‰ğŸŒ
mjkan	æ©˜å­,æ©™å­,èœœæŸ‘
kyep	å¤§é‡ç‰©å“
mot-	åè¯å‰ç¼€ æ›´ ã‚‚ã£ã¨
motkyep	æ›´å¤š
kinjke	ç‚¹å‡»,å•å‡» click
zaj	åŠ è½½,å¢åŠ ,è´Ÿè½½,è½½è·,è½½
ajjne	å¼€èŠ±
hjloajjno	ç¹è£ï¼Œæ˜Œç››
bjbj	å¥¶å¥¶ğŸ‘µ
bobo	çˆ·çˆ·ğŸ‘´
otouto	å¼Ÿå¼Ÿ ãŠã¨ã†ã¨
jmouto	å¦¹å¦¹ ã„ã‚‚ã†ã¨
ko	å­,å„¿å­,å°è¾ˆ
me	å¥³å„¿,å§‘å¨˜,å°è¾ˆ(å¥³æ€§)
you-	åè¯å‰ç¼€ å¹¼å°,å¹¼å¹´,ç¨šå«©,å¹´è½»,æœ‰å…³å¹¼å„¿çš„
youtil	å¹¼å„¿è¯­,å©´å„¿è¯­,å°å­©è¯´çš„è¯/è¯/è¯­æ°”
talabakinj	å¤§å­¦
nao	å¤§è„‘
baturna	å‹‡æ•¢çš„
$aka	ç©ç¬‘
$a$e	æƒŠå¥‡
kaja	å²©çŸ³
juva	çªï¼Œå·¢
ur	å¹¸ç¦ uÄŸur
rol	ä½œç”¨ role
sual	é—®é¢˜
nan	é¦•
ajak	è„š
emjr	å‘½ä»¤
oul	å„¿å­ï¼ŒåœŸï¼šoÄŸul
is$@	å·¥äººğŸ‘·
medjtsjna	åŒ»å­¦ Ğ¼ĞµĞ´Ğ¸Ñ†Ğ¸Ğ½Ğ°
medqara	ä½“æ£€ï¼ŒåŒ»å­¦æ£€æŸ¥ Ğ¼ĞµĞ´Ğ¾ÑĞ¼Ğ¾Ñ‚Ñ€
usta	å·¥åŒ 
sizhak	çƒ­ sÄ±cak
genchna	å¹´å¹¼çš„ genÃ§
sandvjch	ä¸‰æ˜æ²» sandviÃ§
pasta	è›‹ç³•ğŸ° pasta
pastahana	è›‹ç³•åº—ï¼Œçƒ˜åŸ¹åº— pastane
ekmek	é¢åŒ…ğŸ
hasta	ç—…äºº
hastahana	åŒ»é™¢ğŸ¥hastane
jeterlina	å¤Ÿ yeterli
kere	æ¬¡ï¼Œtimes
lytfen	è¯· lÃ¼tfen
cjft	ä¸€å¯¹ï¼Œä¸€åŒ Ã§ift
gyemlek	è¡¬è¡«ğŸ‘”gÃ¶mlek
elbjse	è£™å­ğŸ‘— elbise
etek	çŸ­è£™ etek
uasa	è°£ä¼ ,æµè¨€,é—²è¯,èƒŒåè®®è®º å™‚(ã†ã‚ã•)
epron	å›´è£™ ã‚¨ãƒ—ãƒ­ãƒ³(apron)
yofu	è¥¿è£…,è¥¿æœ,æ´‹è£… æ´‹æœ(ã‚ˆã†ãµã)
kanfu	æ±‰æœ
uafu	å’ŒæœğŸ‘˜
nino	å¸ƒ,å¸ƒæ–™,å¸ƒåŒ¹ å¸ƒ(ã¬ã®)
selafu	æ°´æ‰‹æœ ã‚»ãƒ¼ãƒ©ãƒ¼æœ
se	åˆ¶ä½œ,åˆ¶é€  è£½
poso	åˆ¶åº¦,è§„ç« ,è§„åˆ™ po-se-o
posofu	åˆ¶æœ
jto	ä¸ ç³¸(ã„ã¨)
rjimjto	ä¸çº¿,æ£‰çº¿ rjimj-jto
jtonino	ä¸ç»¸,å¸›
mixj	è™«ğŸ› ã‚€ã—
temixj	èš• ten-mixj
sana	å³ saÄŸ
solna	å·¦ sol
uzakna	è¿œçš„ uzak
achna	é¥¿ aÃ§
a+jarena	é¦™çš„
-+jkna	å½¢å®¹è¯åç¼€ï¼Œç¨ç¨â€¦ï¼Œå¾ˆâ€¦
umarena	èªæ˜çš„
tuzarena	å’¸çš„
a+jsjzna	æ— å‘³çš„
-kjna	å½¢å®¹è¯åç¼€ï¼Œè¡¨ç¤ºâ€¦åœ°ç‚¹ï¼Œâ€¦æ—¶é—´çš„
bukynkina	ä»Šå¤©çš„
-sjna	å½¢å®¹è¯åç¼€ï¼Œç±»ä¼¼â€¦çš„ï¼Œåƒâ€¦çš„
neft	çŸ³æ²¹ neft Ğ½ĞµÑ„Ñ‚ÑŒ
gymy$	é“¶ gÃ¼mÃ¼ÅŸ
tane	ä¸ª tane
dakjka	åˆ†é’Ÿ
dekan	ç³»ä¸»ä»» dekan Ğ´ĞµĞºĞ°Ğ½
debu	èƒ–å­(è´¬ä¹‰) å‡ºä¸(ã§ã¶)
de	å¤–å‡º å‡º(ã§)ã‚‹
chali$kanna	å‹¤å¥‹çš„ Ã§alÄ±ÅŸkan
memur	èŒå‘˜
mydyr	ç»ç†
radjo	æ”¶éŸ³æœºğŸ“»
rektor	å¤§å­¦æ ¡é•¿ rektÃ¶r Ñ€ĞµĞºÑ‚Ğ¾Ñ€
kabe	å¢™å£ ğŸ§±ã‹ã¹
-hen	åè¯åç¼€ åœ¨â€¦æ—è¾¹
imjhen	æµ·è¾¹
tsimolo	æ‰“ç®—,æ„å›¾ ã¤ã‚‚ã‚Š
itagae	è´¨ç–‘,æå‡ºç–‘é—® ç–‘(ã†ãŸãŒ)ã†
komalj	ä¸ºéš¾,æ²¡æœ‰åŠæ³•,éš¾ä»¥å¤„ç† å›°(ã“ã¾)ã‚Š
itagao	ç–‘æƒ‘,ç–‘é—®,å›°æƒ‘
ajzisla	å¤©çº¿ ajzi-sla
prjajzie	æ¥æ”¶,æ”¶åˆ° prj-ajzi-e
magjstral	å¹²çº¿ Ğ¼Ğ°Ğ³Ğ¸ÑÑ‚Ñ€Ğ°Ğ»ÑŒ
admjnjstrator	è¡Œæ”¿äººå‘˜ï¼Œç®¡ç†äººå‘˜ Ğ°Ğ´Ğ¼Ğ¸Ğ½Ğ¸ÑÑ‚Ñ€Ğ°Ñ‚Ğ¾Ñ€
admjnjstratsja	ç®¡ç†ï¼Œè¡Œæ”¿ç®¡ç†
admjnjstratjvna 	è¡Œæ”¿çš„ï¼Œç®¡ç†çš„ï¼Œè¡Œæ”¿ç®¡ç†çš„
%jerna	åœ°çš„
irim$ik	å¥¶ç–™ç˜© å“ˆï¼šiÑ€iĞ¼ÑˆÑ–Ğº
pejnjr	å¥¶é…ª peynir
jste	æƒ³è¦ istemek
ko$e	è·‘ koÅŸmak
uju	ç¡è§‰ğŸ˜ª uyumak
hastana	æœ‰ç—…çš„
erna+jkan	æ€»æ˜¯
mutfak	å¨æˆ¿mutfak 
sljede	éµç…§ + â€¦he (ÑĞ»ĞµĞ´Ğ¾Ğ²Ğ°Ñ‚ÑŒ)
saraj	åœ°æ–¹ saray
kjn#	ç”µå½±é™¢ ĞºĞ¸Ğ½Ğ¾
kjn#jamj	é˜´æš—å¤„,å½±å­
sonra	åœ¨â€¦åï¼ˆæ—¶é—´ï¼‰åç½®ä»‹è¯ sonra
jaze	å†™ åœŸè€³å…¶è¯­yazmak
son	æœ€åçš„ son
tenenjo	å‡ºç”Ÿ birth
turunzhu	æ©˜è‰² turuncu
meny	èœå• menÃ¼
kohjrang	å’–å•¡è‰² kahverengi
sjarang	é»‘è‰²ï¼Œå¢¨æ°´çš„é¢œè‰² siyah
kyeprangna	å¤šå½©çš„ rengarenk
valj$cjhe	ä¸‹é›¨
jama	å‘ ÑĞ¼Ğ°
jaxjk	æŠ½å±‰ ÑÑ‰Ğ¸Ğº
elemjent	å…ƒç´ 
ekskursja	æ¸¸è§ˆï¼Œå‚è§‚ excursion
ekskurs$@	å¯¼æ¸¸
nouarena	ç²¾åŠ›å……æ²›çš„
entuzjazm	çƒ­æƒ…ï¼Œçƒ­å¿± ÑĞ½Ñ‚ÑƒĞ·Ğ¸Ğ°Ğ·Ğ¼
denekj	å‘ç”µç«™
ekran	è§å¹• ÑĞºÑ€Ğ°Ğ½
$ar	çƒä½“ ÑˆĞ°Ñ€
$ahmatlar	å›½é™…è±¡æ£‹ ÑˆĞ°Ñ…Ğ¼Ğ°Ñ‚Ñ‹
$ahmat	æ£‹å­
yelo	æ­»äº¡
yelsjz	æ°¸ç”Ÿ
yelsjzna	æ°¸ç”Ÿçš„
atadano	æ‰¾é›¶ï¼Œæ‰¾å›çš„é’± ÑĞ´Ğ°Ñ‡Ğ°
stjpjendja	å¥–å­¦é‡‘ ÑÑ‚Ğ¸Ğ¿ĞµĞ½Ğ´Ğ¸Ñ
granjtsa	å›½ç•Œï¼Œè¾¹å¢ƒ
dena	ç«¯å£ den-a
sua	æ¸¯å£,å£å²¸ su-a
kirsua	è¿›å£,å¼•è¿› kir-sua
kirdena	å¯¼å…¥,è¾“å…¥,ä¼ å…¥(æ•°æ®ç­‰)
slasua	å‡ºå£(è´§ç‰©ç­‰) export
sladena	è¾“å‡º,å¯¼å‡º,ä¼ å‡º(æ•°æ®ç­‰)
dea	(ç©ºé—´çš„)å‡ºå£ exit
kira	(ç©ºé—´çš„)å…¥å£ entrance
%ola	è·¯å£
tvorj	åˆ›é€  Ñ‚Ğ²Ğ¾Ñ€Ğ¸Ñ‚ÑŒ
%ane	è¯ç”Ÿ,å‡ºç”Ÿ
arka	èƒŒ arka
harjch	é™¤äº†â€¦ hariÃ§
dokilar	ä¸€äº›
dudochka	ç¬›å­ Ğ´ÑƒĞ´Ğ¾Ñ‡ĞºĞ°
brasljet	æ‰‹é•¯ Ğ±Ñ€Ğ°ÑĞ»ĞµÑ‚
jcjgo	è‰è“ğŸ“,æ¨æ¢…
#rmanjcjgo	æ ‘è“
maga	å¼¯æ›²,è½¬å¼¯,æ­ªæ›² æ›²(ã¾)ãŒã‚‹
tsika	æŸ„,æ‰‹æŠŠ,ç¬”æ† æŸ„(ã¤ã‹)
shjolj	å¤„ç† ã—ã‚‡ã‚Š
shjoljtsika	å¥æŸ„ handle
sisime	å‰è¿›,è¿›æ­¥,å¢è¿›,æé«˜ é€²(ã™ã™)ã‚€
sisimjaz	ç¨‹åº pro-gram
shjoljaz	è¿›ç¨‹ process shjolj-sisimjaz
jtosimjaz	çº¿ç¨‹ thread jto-sisimjaz
-do	åŠ¨è¯åç¼€ è¡¨è½¬æŠ˜ æ­¤æ—¶åŠ¨è¯ç›¸å½“äºåè¯ä½†æœ‰æ—¶æ€
fij	å†·ä¸é˜²,çªç„¶,æ„å¤–,å‡ºå…¶ä¸æ„ ä¸æ„(ãµã„)
jtsika	æ›¾ç»,ä»¥å‰,ä¸çŸ¥ä¸è§‰,æ— æ„ä¹‹ä¸­,ä¸çŸ¥ä½•æ—¶
uo	è¯­æ°”è¯ è¡¨å’å¹,èˆ’ç¼“è¯­æ°”
jnfrastruktura	åŸºç¡€è®¾æ–½ Ğ¸Ğ½Ñ„Ñ€Ğ°ÑÑ‚Ñ€ÑƒĞºÑ‚ÑƒÑ€Ğ°  infrastructure
hudj	è¿å¸½å«è¡£ Ñ…ÑƒĞ´Ğ¸
salfjetka	é¤å·¾çº¸ï¼Œçº¸å·¾ ÑĞ°Ğ»Ñ„ĞµÑ‚ĞºĞ°
tusa	å¨±ä¹æ™šä¼šï¼Œèšä¼š Ñ‚ÑƒÑĞ°
kusachka	æŒ‡ç”²åˆ€ ĞºÑƒÑĞ°Ñ‡ĞºĞ°
raschjoska	æ¢³å­
formula	å…¬å¼ Ñ„Ğ¾Ñ€Ğ¼ÑƒĞ»Ğ°
kulak	è€³æœµğŸ‘‚
kulaktenmonolar	è€³æœºğŸ§ Ğ½Ğ°ÑƒÑˆĞ½Ğ¸ĞºĞ¸
arkahjt	æœ‹å‹ arka-hjt
hana	é¼»å­ğŸ‘ƒ
barhan	æ²™ä¸˜ Ğ±Ğ°Ñ€Ñ…Ğ°Ğ½
oj$@	æ€æƒ³è€… Ğ¼Ñ‹ÑĞ»Ğ¸Ñ‚ĞµĞ»ÑŒ
um$@	æ™ºè€…
asasq#j$@	ç¼”é€ è€…
fjlosofja	å“²å­¦ Ñ„Ğ¸Ğ»Ğ¾ÑĞ¾Ñ„Ğ¸Ñ
alkir	æ‹¿è¿›ï¼Œåˆ—å…¥ï¼Œæå‡º Ğ²Ğ½ĞµÑÑ‚Ğ¸
pjtae	å–‚å…»ï¼Œä¾›ç»™ Ğ¿Ğ¸Ñ‚Ğ°Ñ‚ÑŒ
pjtano	å–‚å…»ï¼Œä¾›ç»™ï¼Œè¥å…»
pjtatene	æ•™è‚² Ğ²Ğ¾ÑĞ¿Ğ¸Ñ‚Ğ°Ñ‚ÑŒ
pjtatenno	æ•™è‚²
matjerjal	ææ–™ï¼Œèµ„æ–™
propaganda	å®£ä¼ 
propagandaq@le	å®£ä¼ 
so$oalna	ç¤¾ä¼šçš„
umalna	æ™ºåŠ›çš„
norma	æ ‡å‡†
qara#rmanka	æ¦†æ ‘
%ol$@	æ—…å®¢
kjoklja	æ¸…æ˜ kjo-klja
pjtaten$@	æ•™è‚²è€…
pjtaten$@na	æ•™è‚²æ€§çš„
pjtatencevmono	å—æ•™è‚²è€…
bi	éƒ¨ï¼Œå±€ï¼Œå¤„ï¼Œç§‘ï¼Œç¯‡ï¼Œéƒ¨åˆ†
binaq	å•ç‹¬åœ°
bina	å•ç‹¬çš„ï¼Œç‹¬ç«‹çš„
$ej	ä¸œè¥¿ ÅŸey
mukae$@n@st	çŠ¹è±«
mukae$@	çŠ¹è±«è€…
mukae$@na	çŠ¹è±«çš„
spredb&l	åŒºåˆ†
spredb&lcj	åˆ†æˆï¼ˆè‹¥å¹²éƒ¨åˆ†ï¼‰
vib&l	åˆ†å‡ºï¼ŒæŠ½å‡ºï¼Œæ‹¨å‡º(æ—¶é—´ç­‰)
posljede	è¿½éšï¼Œè·Ÿéš
posljed$@	è¿½éšè€…
guman	ä»
gumanna	ä»çˆ±çš„ï¼Œäººé“çš„
gumanjzm	äººé“ä¸»ä¹‰
egake	ç»˜ç”»,ä½œç”»,æç»˜,æå†™ æ(ãˆãŒ)ã
makarna	é¢æ¡
issjzna	å¤±ä¸šçš„
vrach	åŒ»ç”Ÿ Ğ²Ñ€Ğ°Ñ‡
doru	æœï¼Œå‘ doÄŸru
otel	æ—…åº—
ojun$@	æ¼”å‘˜ oyuncu
kensa	æ£€æŸ¥
poluche	å¾—åˆ°
zapoluchecevna	åº”å¾—çš„
%jebjecev	æ¸´æœ›ï¼Œå¥”å¾€ï¼Œå†²å‘
%jebjecevno	æ¸´æœ›
%jebjena	æ€¥é€Ÿçš„,æ€¥å‰§çš„
takala	å®ç‰©,çå® ãŸã‹ã‚‰
nose	å¸¦ï¼Œæºå¸¦
nos$@	è½½ä½“ï¼Œæºå¸¦è€… Ğ½Ğ¾ÑĞ¸Ñ‚ĞµĞ»ÑŒ
kisana	çŸ­çš„
gadae	çŒœ Ğ³Ğ°Ğ´Ğ°Ñ‚ÑŒ
sjeno	ä¿¡ä»°
musjendekjna	éš¾ä»¥ç½®ä¿¡çš„
tajna	ç§˜å¯†
tajnstvona	ç¥ç§˜çš„
jtosjz	æ— çº¿
%olyet	è·¯ç”±
%olyet$@	è·¯ç”±å™¨ router
jtoaro	æœ‰çº¿
tenjto	åœ¨çº¿
cjto	ä¸‹çº¿,ç¦»çº¿,çº¿ä¸‹
svjaz	è”ç³» ÑĞ²ÑĞ·ÑŒ
noubanka	å……ç”µå®power bank
bjleq	ç”šè‡³ bile
siqsiq	ç»å¸¸
gu	å›º,åšå›º,å‡å›º,å›ºä½“,å›ºæ€,å›ºå®š
gudenyn	å›ºå®šç”µè¯,åº§æœº
nosedenyn	æºå¸¦ç”µè¯,æ‰‹æœº,ç§»åŠ¨ç”µè¯
djemadeno	æ¡çº¦ï¼Œå¥‘çº¦ï¼ŒåˆåŒ Ğ´Ğ¾Ğ³Ğ¾Ğ²Ğ¾Ñ€
pjerjedjeno	å¯¹è¯ï¼Œé€šè¯ï¼Œæ´½è°ˆï¼Œåå•† Ğ¿ĞµÑ€ĞµĞ³Ğ¾Ğ²Ğ¾Ñ€
poahae	ä¿®æ­£ï¼Œæ”¹æ­£
poahaka	ä¿®æ­£ï¼Œæ ¡æ­£ï¼Œè°ƒæ•´ï¼Œä¿®æ”¹ï¼Œä¿®æ­£æ¡ˆ
yazjxxjoka	åå•ï¼Œç›®å½•ï¼Œæ¸…å•
igoke	è¿åŠ¨,æ´»åŠ¨,ç§»åŠ¨,åŠ¨ä½œ å‹•(ã†ã”)ã
igokresim	åŠ¨ç”»,è§†é¢‘ video
pokinje	æ”¾ç½®ï¼Œå®‰æ”¾ï¼ŒĞ¿Ğ¾Ğ¼ĞµÑÑ‚Ğ¸Ñ‚ÑŒ
tsena	ä»·æ ¼
hejlamj	å±å¹•,æ˜¾ç¤ºå± hej-lamj
bjlno	çŸ¥è¯†
eljtna	ç²¾é€‰çš„ï¼Œè‰¯ç§çš„ ÑĞ»Ğ¸Ñ‚Ğ½Ñ‹Ğ¹
eljta	è‰¯ç§ï¼Œæ°å‡ºäººç‰©
jnfarkt	æ¢—å¡ï¼Œæ¢—æ­» Ğ¸Ğ½Ñ„Ğ°Ñ€ĞºÑ‚
karta	å¡ç‰‡ ĞºĞ°Ñ€Ñ‚Ğ°
kvartjra	å…¬å¯“apartment ĞºĞ²Ğ°Ñ€Ñ‚Ğ¸Ñ€Ğ°
kvartal	è¡—åŒº ĞºĞ²Ğ°Ñ€Ñ‚Ğ°Ğ»
sauae	è§¦æ‘¸,ç¢°è§¦,æ¥è§¦,æŠšæ‘¸ è§¦(ã•ã‚)ã‚‹
sauaslae	è§¦å‘
fljp	å¼¹åŠ¨,(ä½¿)å¿«é€Ÿç¿»è½¬,è¿…é€Ÿç¿»åŠ¨,æŒ‰(æŒ‰é’®) flip
flop	çŒ›ç„¶åä¸‹,(æ²‰é‡)è½ä¸‹
fljpflop	è§¦å‘å™¨ åœ¨æ—¶é’Ÿä¿¡å·æ”¹å˜æ—¶é‡‡æ ·çš„å­˜å‚¨ç”µè·¯
jes$@	å¯„å­˜å™¨ ç”±è§¦å‘å™¨ç»„åˆæ„æˆ æœ‰æé«˜è¯»å†™é€Ÿåº¦
kagj$@	é”å­˜å™¨ latch
meme	å­˜å‚¨,å­˜æ”¾,è®°å¿† memorize
memono	å†…å­˜,å­˜å‚¨å™¨ memory
mahae	æŒ¥åŠ¨ Ğ¼Ğ°Ñ…Ğ°Ñ‚ÑŒ
bambuk	ç«¹å­ Ğ±Ğ°Ğ¼Ğ±ÑƒĞº
ajuneko	å¤§ç†ŠçŒ«ğŸ¼
xjsen	å››å·
sejto	æˆéƒ½
kyou	ç–†åŸŸ,å›½åœŸ
%anakyou	æ–°ç–†
kisahejnja	è‰åŸ
ixje	æ”¾ç‰§,æ¸¸ç‰§
ijxoba	ç‰§åœº
menljixjoba	ä¹Œé²æœ¨é½ ä¼˜ç¾çš„ç‰§åœº
rossja	ä¿„ç½—æ–¯
afrjka	éæ´²
volosa(lar)	å¤´å‘ Ğ²Ğ¾Ğ»Ğ¾ÑĞ°
valjenka(lar)	æ¯¡é´  Ğ²Ğ°Ğ»ĞµĞ½ĞºĞ¸
-so	åè¯åç¼€ å…ƒç´ 
suso	æ°¢,æ°´ç´ 
soususo	æ°˜
trj	ä¸‰ 3
trjsuso	æ°š
kisasuslana	çŸ­æš‚çš„ kisa(å–â€œçŸ­â€ä¹‹æ„)-susla
kjxj	å²¸ ãã—
rukav	è¢–å­ Ñ€ÑƒĞºĞ°Ğ²
rukavsjzka	é©¬ç”² Ğ±ĞµĞ·Ñ€ÑƒĞºĞ°Ğ²ĞºĞ°
dokioj$@	çŸ¥å·±ï¼Œå¿—åŒé“åˆçš„äºº
r#sk@$	å¥¢ä¾ˆ Ñ€Ğ¾ÑĞºĞ¾ÑˆÑŒ
k@$mar	å™©æ¢¦ï¼Œæ¢¦é­‡ ĞºĞ¾ÑˆĞ¼Ğ°Ñ€
odajaka	å¹³ç¨³,å¹³é™,æ¸©å’Œ,ç¨³å¦¥
#jlasjzna	ä¸å¯æ€è®®çš„,éš¾ä»¥ç½®ä¿¡çš„,å¥‡å¦™çš„
jlka	å­£èŠ‚ jl-ka
iken	å›› ï¼ˆjlka jn å­£èŠ‚çš„ï¼‰å‘ç”ŸéŸ³å˜è€Œæ¥
bex	äº” beÅŸ
pitae	é—®
savjs	æœåŠ¡ service
savjs$@	æœåŠ¡å™¨
savjse	ä¸ºâ€¦æä¾›æœåŠ¡
savjso	æœåŠ¡å‘˜
lok	å…­ 6 ã‚ã
rezhen	ä¸ƒ ï¼ˆç”±å½©è™¹çš„ raduga jn éŸ³å˜å¾—åˆ°ï¼‰
uzunhalj	é•¿æ˜¥
%yrjekaq	å–„è‰¯ %yrjek-aq
%yrjekaqna	å–„è‰¯çš„
jojsjn	ä½ å¥½ï¼
pokyercevo	ç›¸é‡
+jkanhe	å†è§ï¼
jojna tang	æ—©ä¸Šå¥½ï¼
jojna kyn	ä¸­åˆå¥½ï¼
jojna tasogale	æ™šä¸Šå¥½ï¼
xjzikana tyn	æ™šå®‰ï¼
komevarka	ç”µé¥­ç…² Ñ€Ğ¸ÑĞ¾Ğ²Ğ°Ñ€ĞºĞ°
k#mjks	è¿ç¯ç”»
stsena	èˆå° ÑÑ†ĞµĞ½Ğ°
stsenarj	å‰§æœ¬ ÑÑ†ĞµĞ½Ğ°Ñ€Ğ¸Ğ¹
pj%ama	ç¡è¡£ Ğ¿Ğ¸Ğ¶Ğ°Ğ¼Ğ°
truslar	çŸ­è£¤ï¼Œè£¤è¡© Ñ‚Ñ€ÑƒÑÑ‹
kjteno	è¢«å­ Ğ¾Ğ´ĞµÑĞ»Ğ¾
pakjet	çº¸è¢‹ï¼Œå°è¢‹å­ Ğ¿Ğ°ĞºĞµÑ‚ packet
marker	é©¬å…‹ç¬”
flomaster	å¸æ°´ç¬”ï¼Œå½©è‰²æ°´ç¬” flowmaster Ñ„Ğ»Ğ¾Ğ¼Ğ°ÑÑ‚ĞµÑ€
fle$ka	Uç›˜ Ñ„Ğ»ĞµÑˆĞºĞ°
skrjepka	å›å½¢é’ˆ ÑĞºÑ€ĞµĞ¿ĞºĞ°
n#%	åˆ€ Ğ½Ğ¾Ğ¶
n#%monolar	å‰ªåˆ€âœ‚ï¸ Ğ½Ğ¾Ğ¶Ğ½Ğ¸Ñ†Ñ‹
garm#nja	æ‰‹é£ç´ Ğ³Ğ°Ñ€Ğ¼Ğ¾Ğ½Ğ¸Ñ
gubagarm#nja	å£ç´ Ğ³ÑƒĞ±Ğ½Ğ°Ñ Ğ³Ğ°Ñ€Ğ¼Ğ¾Ğ½Ğ¸Ñ
kopja	å¤å°ä»¶ ĞºĞ¾Ğ¿Ğ¸Ñ
sagase	æœç´¢,æœå¯»,å¯»æ‰¾ æ¢(ã•ãŒ)ã™
kikak	åŒºåŸŸ,åˆ†åŒº,åœ°åŒº,åŒºåˆ’ åŒºç”»(ãã‹ã)
sagasmono	æœç´¢è€…ï¼Œæœç´¢å¼•æ“
spredbjer	åˆ†é…,åˆ†å‘ spred-bjer
vibjer	å‘æ”¾ï¼Œå‘ç»™ vi-bjer
bjerdane	çŒ®ç»™ 
fito	ç²—,èƒ– å¤ª(ãµã¨)ã„
momo	è…¿ è‚¡(ã‚‚ã‚‚)
fitomomo	å¤§è…¿
pobjer	é€’
cjn	å®˜å‘˜ Ñ‡Ğ¸Ğ½
cjncje	æœä»
cjncjeceve	æœä»äº
ostacev	ä¿æŒ
prjostacev	éµå®ˆ
set	è®¾ç½®,å»ºç«‹,ç½®ä½
muset	æ¸…é™¤,é‡ç½®,å¤ä½
gruda	å †ï¼Œä¸€å¤§å † Ğ³Ñ€ÑƒĞ´Ğ°
xjegolje	ç‚«è€€ Ñ‰ĞµĞ³Ğ¾Ğ»ÑÑ‚ÑŒ/Ñ‰ĞµĞ³Ğ¾Ğ»ÑŒĞ½ÑƒÑ‚ÑŒ
sovae	æ’è¿›ï¼Œéšä¾¿å¡å…¥ ÑĞ¾Ğ²Ğ°Ñ‚ÑŒ
bje	æ‰“ Ğ±Ğ¸Ñ‚ÑŒ beat
zabjer	æå‡ºï¼Œå¸ƒç½®ï¼Œä¸¾è¡Œ za-bjer Ğ·Ğ°Ğ´Ğ°Ñ‚ÑŒ
zabjera	ä»»åŠ¡
syjkire	çˆ±ä¸Š
duh	ç²¾ç¥ Ğ´ÑƒÑ…
on	å
y	ï¼ˆå›ºæœ‰ï¼‰ä¹
os	å…« 8
kouaq@le	å“å”¬ï¼Œä½¿å®³æ€•
kouaq@lcev	æ„Ÿåˆ°å®³æ€•
kouaq@lcevna	è¢«å“åˆ°çš„
kouana	ææ€–çš„
kouaq@lna	å“äººç”¨çš„
pr@se	è¯·æ±‚ Ğ¿Ñ€Ğ¾ÑĞ¸Ñ‚ÑŒ
pr@so	è¯·æ±‚
ko$dane	é€ƒè·‘ ko$-dan
sauacev	æ¶‰åŠï¼Œè°ˆåŠï¼Œè®ºåŠ saua-cev
t@ndacev	å¬ä» t@nda-cev
stoje	å€¼ï¼ˆå¤šå°‘é’±ï¼‰ï¼Œå€¼å¾— ÑÑ‚Ğ¾Ğ¸Ñ‚ÑŒ
polna	æ»¡çš„ Ğ¿Ğ¾Ğ»Ğ½Ñ‹Ğ¹
en-	å›´ç»•
ene	å›´ç»•ï¼ŒæŠŠâ€¦å›´ä½
o%jdae	æœŸå¾… Ğ¾Ğ¶Ğ¸Ğ´Ğ°Ñ‚ÑŒ
%elae	ç¥æ„¿ Ğ¶ĞµĞ»Ğ°Ñ‚ÑŒ
%elano	ç¥ç¦
igokno	ç§»åŠ¨ï¼ŒåŠ¨ä½œï¼Œæ´»åŠ¨ï¼ŒåŠ¨æ€
-stvo	åè¯åç¼€ï¼Œä½¿åŸæ¥çš„åè¯æ›´åŠ æŠ½è±¡ï¼Œè½¬ä¹‰åç¼€
mastjer	åŒ äºº
ite	å”±
ita$@	æ­Œæ‰‹
arsie	å®ç° are-si
aro	æœ¬è´¨
kjzi$@	å»ºé€ è€…
kjzika	å·¥åœ°
kjzistvo	å»ºè®¾äº‹ä¸šï¼Œå»ºç­‘å·¥ç¨‹
kjzina	æ’åˆ—æ•´é½çš„ï¼Œä¸¥æ•´çš„
kjzi$@na	å»ºç­‘çš„
kjzisie	å®‰æ’ï¼Œç»„ç»‡ï¼Œä¸¾åŠ
kjzisio	ç»„ç»‡ï¼Œå®‰æ’ï¼Œå¸ƒç½®
kjzisiostvo	è£…ç½®ï¼Œä½“åˆ¶ï¼Œè®¾å¤‡
kjzisi$@	ç»„ç»‡è€…
kjzisiecev	è¢«å®‰æ’ï¼Œæ‰¾åˆ°å·¥ä½œï¼Œå°±ä¸š
kjzisiecevna	å®‰æ’å¦¥å–„çš„
-elaj	è¡¨å¤§åç¼€
podotenelajo	ä¼˜åŠ¿ï¼Œä¼˜è¶Šæ€§
jlkna	åˆæ¬¡çš„ï¼Œæœ€åˆçš„ ilk
naka	ä¸­é—´,ä¸­éƒ¨,è…¹éƒ¨,ä¸­å¿ƒ ä¸­(ãªã‹)
nakastvo	è…¹åœ°,ç›†åœ°
karjyer	äº‹ä¸š career
mjera	å°ºåº¦,åº¦é‡ Ğ¼ĞµÑ€Ğ°
lo+jkalna	æœ‰é€»è¾‘çš„ï¼Œæœ‰é“ç†çš„
mjeduza	æ°´æ¯ Ğ¼ĞµĞ´ÑƒĞ·Ğ°
yetsyez	å¯†ç  password
yezyel	è‡ªæ€
olje	çººç»‡,ç¼–ç»‡ ç¹”(ãŠ)ã‚‹
hjme	å…¬ä¸»,å§‘å¨˜,å°çš„(å‰ç¼€),å¯çˆ±çš„(å‰ç¼€) å§«(ã²ã‚)
oljohjme	ç»‡å¥³ ç¹”å§«(ãŠã‚Šã²ã‚)
hjko	ç”·å­ç¾ç§° å½¦(ã²ã“)
njuhae	é—»
ilisana	å˜ˆæ‚ã€çƒ¦äººçš„ ã†ã‚‹ã•ã„
raps	æ²¹èœ Ñ€Ğ°Ğ¿Ñ
zenzenq	å®Œå…¨,å…¨ç„¶
mah	é­”æ³• Ğ¼Ğ°Ğ³
tortenna	çœŸæ­£çš„ tor-ten-na
djl	çµé­‚,å¿ƒçµ
tortenna ku$ma syjena hjt	çœŸæ­£çš„çˆ±é¸Ÿäºº,(æ¯”å–»ä¸ºæ„Ÿæƒ…æ”¾æ‰‹çš„äºº)
vjejer	æ‰‡å­ Ğ²ĞµĞµÑ€
vjernisa%	(è‰ºæœ¯å±•)é¢„å±•,å¼€å¹•æ—¥ Ğ²ĞµÑ€Ğ½Ğ¸ÑĞ°Ğ¶, vernissage
-$@na	æ€§è´¨å½¢å®¹è¯åç¼€,$@åœ¨è¿™é‡Œæ„ä¸ºâ€œå…·æœ‰â€¦ç‰¹æ€§è€…â€
ka$@na	åšå†³çš„,æœæ–­çš„ kaeçš„æ€§è´¨å½¢å®¹è¯
yeztor$@na	ç‹¬ç«‹çš„,è‡ªä¸»çš„
zen-	å‰ç¼€,å‰ ãœã‚“ (æ—¶é—´ é¡ºåº)
zenkalar	ç¥–å…ˆ Ğ¿Ñ€ĞµĞ´ĞºĞ¸
mjelodja	æ—‹å¾‹ melody
mjelodjkna	æ‚¦è€³çš„ melodic Ğ¼ĞµĞ»Ğ¾Ğ´Ğ¸Ñ‡Ğ½Ñ‹Ğ¹
banalna	è€ç”Ÿå¸¸è°ˆçš„,é™ˆè…çš„ Ğ±Ğ°Ğ½Ğ°Ğ»ÑŒĞ½Ñ‹Ğ¹ banal
tajnstvo	ç¥ç§˜ Ñ‚Ğ°Ğ¸Ğ½ÑÑ‚Ğ²Ğ°
pjejza%	é£æ™¯ Ğ¿ĞµĞ¹Ğ·Ğ°Ğ¶
stjerjeotjp	é™ˆè§„æ—§ä¹ ,åˆ»æ¿å°è±¡ ÑÑ‚ĞµÑ€ĞµĞ¾Ñ‚Ğ¸Ğ¿ stereotype
doki+jkannaq	åŒæ—¶
en%yr	ç»•è¿‡
muen%yrna	å¿…é¡»çš„,(ç»•ä¸å¼€çš„)
muen%yrnaq	å¿…é¡»,ä¸€å®š
muen%yrn@st	å¿…è¦æ€§
pobahtcev	èµ°è¿po-baht-cev Ğ¿Ğ¾ÑÑ‡Ğ°ÑÑ‚Ğ»Ğ¸Ğ²Ğ¸Ñ‚ÑŒÑÑ
tyne	è¿‡å¤œ Ğ¿ĞµÑ€ĞµĞ½Ğ¾Ñ‡ĞµĞ²Ğ°Ñ‚ÑŒ,Ğ½Ğ¾Ñ‡ĞµĞ²Ğ°Ñ‚ÑŒ
cjerjep	å¤´éª¨ Ñ‡ĞµÑ€ĞµĞ¿
katasi	ä½¿å¢åŠ  kata-si
katasielaje	å¤¸å¤§ Ğ¿Ñ€ĞµÑƒĞ²ĞµĞ»Ğ¸Ñ‡Ğ¸Ğ²Ğ°Ñ‚ÑŒ exaggerate
pjtacev$@	å® ç‰© pjta-cev-$@  Ğ¿Ğ¸Ñ‚Ğ¾Ğ¼ĞµÑ†
jyn+y	ä¸æ˜¯,é”™ (è‡ªé€ è¯)
$jn$jlla	é¾™çŒ«,å—ç¾æ´²æ —é¼ ,ç»’æ¯›ä¸é¼ 
kamotsi	è´§ç‰© ã‹ã‚‚ã¤
pjon	èŠè¯ Ğ¿Ğ¸Ğ¾Ğ½
formulaq@le	è¡¨è¿°,ä¸‹å®šä¹‰
prjnts	(è¥¿æ–¹çš„)ç‹å­Ğ¿Ñ€Ğ¸Ğ½Ñ†
prjnts aqna at tenda	ç™½é©¬ç‹å­ Ğ¿Ñ€Ğ¸Ğ½Ñ† Ğ½Ğ° Ğ±ĞµĞ»Ğ¾Ğ¼ ĞºĞ¾Ğ½Ğµ
molje	ç¥ˆæ±‚,æ³æ±‚Ğ¼Ğ¾Ğ»Ğ¸Ñ‚ÑŒ
moljcev	åšç¥·å‘Š
pauasie	ä½¿å¢å¼º,å¢å¤§ ÑƒÑĞ¸Ğ»Ğ¸Ğ²Ğ°Ñ‚ÑŒ paua-si
xjzikacje	å¹³æ¯,å‡å° ÑÑ‚Ğ¸Ñ…Ğ°Ñ‚ÑŒ xjzika-cj
produkt	äº§å“
imjprodukt	æµ·äº§å“
vata	æ£‰èŠ± Ğ²Ğ°Ñ‚Ğ°
amena vata	æ£‰èŠ±ç³– ÑĞ°Ñ…Ğ°Ñ€Ğ½Ğ°Ñ Ğ²Ğ°Ñ‚Ğ°
yettee	ç ä¼,å‡¿ç©¿,å¼€è¾Ÿ Ğ¿Ñ€Ğ¾Ñ€ÑƒĞ±Ğ¸Ñ‚ÑŒ yet-te
yetteka	çªŸçª¿,å­”,å†°çªŸçª¿ Ğ¿Ñ€Ğ¾Ñ€ÑƒĞ±ÑŒ
podojolo	å¼€å§‹
podojoloq@le	å‡ºå‘,èµ·é£ ÑÑ‚Ğ°Ñ€Ñ‚Ğ¾Ğ²Ğ°Ñ‚ÑŒ
momjent	æ—¶åˆ»
yez#qu	è‡ªå­¦
yez#qu$@	è‡ªå­¦è€…
#qumono	è¯¾æœ¬,æ•™æ
yez#qumono	è‡ªå­¦è¯¾æœ¬
syjcev$@	å® å„¿ Ğ»ÑĞ±Ğ¸Ğ¼ĞµÑ†
rakjeta	ğŸš€ç«ç®­ Ñ€Ğ°ĞºĞµÑ‚Ğ°
spredbjercev	ä¼ æ¥,æƒ³èµ· Ñ€Ğ°Ğ·Ğ´Ğ°Ñ‚ÑŒÑÑ
dollar	ç¾å…ƒ $
%jeruang	åœ°éœ‡ Ğ·ĞµĞ¼Ğ»ĞµÑ‚Ñ€ÑÑĞµĞ½Ğ¸Ğµ
eljemna	å®‡å®™çš„ ĞºĞ¾ÑĞ¼Ğ¸Ñ‡ĞµÑĞºĞ¸Ğ¹
eljemna kema	å®‡å®™é£èˆ¹
jojnapoluchna	é¡ºåˆ©çš„ Ğ±Ğ»Ğ°Ğ³Ğ¾Ğ¿Ğ¾Ğ»ÑƒÑ‡Ğ½Ğ¾
jojnapoluchnaq	é¡ºåˆ©åœ°
b#rt tenda	è½½æœ‰ Ğ½Ğ° Ğ±Ğ¾Ñ€Ñ‚Ñƒ, on board, aboard
eljemgaki	èˆªå¤©å­¦
%anna	ç”Ÿæ­»æ”¸å…³çš„,é€¼çœŸçš„,ç”Ÿæ´»çš„ Ğ¶Ğ¸Ğ·Ğ½ĞµĞ½Ğ½Ñ‹Ğ¹, vital
grandjozna	å®ä¼Ÿçš„ Ğ³Ñ€Ğ°Ğ½Ğ´Ğ¸Ğ¾Ğ·Ğ½Ñ‹Ğ¹ grandiose
hjlceve	åŠ å®½,å˜å®½,æ‰©å¤§
objem	ä½“ç§¯,å®¹ç§¯,è§„æ¨¡ Ğ¾Ğ±ÑŠĞµĞ¼
orbjta	è½¨é“ Ğ¾Ñ€Ğ±Ğ¸Ñ‚Ğ° orbit
vode	é¢†,é©¾é©¶  Ğ²Ğ¾Ğ´Ğ¸Ñ‚ÑŒ
yetvode	è¿›è¡Œ,åº¦è¿‡,å¼•å¯¼,é¢†è¿‡ Ğ¿Ñ€Ğ¾Ğ²Ğ¾Ğ´Ğ¸Ñ‚ÑŒ
yetvodmono	å¯¼ä½“ Ğ¿Ñ€Ğ¾Ğ²Ğ¾Ğ´Ğ½Ğ¸Ğº
polu-	å‰ç¼€,åŠ
poluyetvodmono	åŠå¯¼ä½“ Ğ¿Ğ¾Ğ»ÑƒĞ¿Ñ€Ğ¾Ğ²Ğ¾Ğ´Ğ½Ğ¸Ğº
uzaksie	å»é™¤,é€€ç¦»,æ’é™¤
uzaksio	æ’é™¤,è·ç¦»,è¿œç¦» ÑƒĞ´Ğ°Ğ»ĞµĞ½Ğ¸Ğµ
potenn@st	è¡¨é¢ po-ten-n@st
musuna	ç²—æå¤§å¶çš„,é©¬è™çš„,ç–å¿½çš„ Ğ½ĞµĞ±Ñ€ĞµĞ¶Ğ½Ñ‹Ğ¹
musuelajĞµ	è½»è§†,è”‘è§† Ğ¿Ñ€ĞµĞ½ĞµĞ±Ñ€ĞµÑ‡ÑŒ
b#dricje	é¼“åŠ±,é¼“èˆ Ğ¿Ğ¾Ğ´Ğ±Ğ¾Ğ´Ñ€Ğ¸Ñ‚ÑŒ
sapfjr	è“å®çŸ³ ÑĞ°Ğ¿Ñ„Ğ¸Ñ€ sapphire
rangsie	ç€è‰²,æŸ“è‰² ÑƒĞºÑ€Ğ°ÑĞ¸Ñ‚ÑŒ
kljk	å–Šå« ĞºĞ»Ğ¸Ğº
kljknue	å–Šä¸€æ¬¡ ĞºĞ»Ğ¸ĞºĞ½ÑƒÑ‚ÑŒ
kljkten	é«˜å‘¼,æƒŠå¹, Ğ²Ğ¾ÑĞºĞ»Ğ¸ĞºĞ½ÑƒÑ‚ÑŒ
vikljk	å–Šå‡º Ğ²Ñ‹ĞºĞ»Ğ¸ĞºĞ°Ñ‚ÑŒ
zaosta	æ‰£ç•™,æŒ¡ä½,æ‹–å»¶,æŠ“ä½ Ğ·Ğ°Ğ´ĞµÑ€Ğ¶Ğ°Ñ‚ÑŒ
zaostacev	åœç•™,å»¶è¯¯
soto-	å‰ç¼€,å¤–â€¦
soto%jerna	åœ°å¤–çš„ Ğ²Ğ½ĞµĞ·ĞµĞ¼Ğ½Ğ¾Ğ¹
soton@st	å¤–è¡¨ Ğ²Ğ½ĞµĞ¶Ğ½Ğ¾ÑÑ‚ÑŒ
t#pljv@	ç‡ƒæ–™ Ñ‚Ğ¾Ğ¿Ğ»Ğ¸Ğ²Ğ¾
mudokikerenaq	å±¡æ¬¡ Ğ½ĞµĞ¾Ğ´Ğ½Ğ¾ĞºÑ€Ğ°Ñ‚Ğ½Ğ¾
itatene	æ­Œé¢‚,é¢‚æ‰¬ ita-ten Ğ²Ğ¾ÑĞ¿ĞµÑ‚ÑŒ
itatencevna	è¢«é¢‚æ‰¬çš„
cyke	æŒ‚ç€,æ‚¬æŒ‚ç€(è‡ªé€ è¯)
zacyke	ä¾èµ–
muzacykecevna	ä¸å—åˆ¶äºäººçš„,ç‹¬ç«‹çš„
sloj	å±‚,ÑĞ»Ğ¾Ğ¹
rjemjen	çš®å¸¦ Ñ€ĞµĞ¼ĞµĞ½ÑŒ
kjet#jlacev	æ„Ÿåˆ°å¤±æœ› Ğ¾Ñ‚Ñ‡Ğ°Ğ¸Ğ²Ğ°Ñ‚ÑŒÑÑ
hej@st	ç›˜å­,ç¢Ÿå­
jnljok	å¼•åŠ›
tagaj	ç›¸äº’,äº’ç›¸ äº’(ãŸãŒ)ã„
pauana	å¼ºå¤§çš„,æœ‰åŠ›é‡çš„
pauanatagajejkyouljok	å¼ºç›¸äº’ä½œç”¨åŠ›
jouana	å¼±çš„,è„†å¼±çš„,è½¯å¼±çš„ å¼±(ã‚ˆã‚)ã„
jouanatagajejkyouljok	å¼±ç›¸äº’ä½œç”¨åŠ›
+j	ç£ ã˜
den+jljok	ç”µç£åŠ›
ljok	åŠ› ç§‘å­¦æ¦‚å¿µ
masatsi	æ‘©æ“¦ ã¾ã•ã¤
masatsiljok	æ‘©æ“¦åŠ›
fljpljok	å¼¹åŠ›
kjetnakaljok	ç¦»å¿ƒåŠ›
vanderuallsljok	èŒƒå¾·ååŠ›
fita	ç›–å­ ãµãŸè“‹
fite	ç›–,åŠ¨è¯
zafite	ç›–ä¸Š,å…³ä¸Š,é—­ä¸Š
zafite kyezlar â€¦he	æ— è§†â€¦
estja	é™†åœ° est-ja
te%uhana	å•æ‰€,æ´—æ‰‹é—´ te-%u-hana
tagajsvjazna	ç›¸äº’è”ç³»çš„
kodokina	å­¤ç‹¬çš„
poljtjka	æ”¿æ²» Ğ¿Ğ¾Ğ»Ğ¸Ñ‚Ğ¸ĞºĞ°
yelna	ä¸å…ä¸€æ­»çš„,è‡´æ­»çš„,å¿…æ­»çš„ ÑĞ¼ĞµÑ€Ñ‚Ğ½Ñ‹Ğ¹
yelna kisi	å‡¡äºº
ukrajna	ä¹Œå…‹å…°
aqrussja	ç™½ä¿„ç½—æ–¯
cjcjka	åœŸå£¤ cj-cjka
tee	ç ä¼
anko	è§†åŠ›
ankoten	è§‚ç‚¹,çœ‹æ³• Ğ²Ğ¾Ğ·Ğ·Ñ€ĞµĞ½Ğ¸Ğµ
mjrankoten	ä¸–ç•Œè§‚ Ğ¼Ğ¸Ñ€Ğ¾Ğ²Ğ¾Ğ·Ğ·Ñ€ĞµĞ½Ğ¸Ğµ
trans-	å˜,è½¬,å‰ç¼€
susjzsi	ä½¿â€¦è„±æ°´,é™¤æ°´ Ğ¾Ğ±ĞµĞ·Ğ²Ğ¾Ğ¶Ğ¸Ğ²Ğ°Ñ‚ÑŒ
ozon	è‡­æ°§ ozone Ğ¾Ğ·Ğ¾Ğ½
nona	é‡çš„
arjxxjo	å…±å­˜
nolana	æ— å®¶å¯å½’çš„
kirsuana	è¿›å£çš„ imported
brodje	å¾˜å¾Š Ğ±Ñ€Ğ¾Ğ´Ğ¸Ñ‚ÑŒ
prjajzit@ndae	æ¥å¬(ç”µè¯ç­‰) prjajzi-t@nda-e
$vabra	æ‹–æŠŠ ÑˆĞ²Ğ°Ğ±Ñ€Ğ°
urna	å¹¸è¿çš„
bahtna	å¹¸ç¦çš„
urno	å¹¸äº‹
urka	å¹¸è¿ç¬¦
bulut	äº‘,bulut
lombard	å½“é“º Ğ»Ğ¾Ğ¼Ğ±Ğ°Ñ€Ğ´
kvadrat	æ­£æ–¹å½¢,ç«‹æ–¹ä½“,æ–¹å— quadrate  ĞºĞ²Ğ°Ğ´Ñ€Ğ°Ñ‚
muzvalj$	å†°é›¹
yete$@	è·¯äºº,è¿‡è·¯äºº
altinna	é‡‘è‰²çš„
avtonou	å‡½æ•°
hejlamje	æ˜¾ç¤º,æ˜¾ç°
hejlamjohate	ç»“æœ,æ•ˆæœ,æˆæœ
hejlamjohatesi	ç”Ÿæ•ˆ
arsio	åŠŸèƒ½,å®ç°
njku	å›°éš¾,è‰°éš¾ é›£(ã«ã)ã„
-njkuna	åŠ¨åè¯åç¼€,åšâ€¦å¾ˆéš¾,ä¸å®¹æ˜“åŠâ€¦
qaranjkuna	ä¸‘é™‹çš„,éš¾çœ‹çš„ é†œ(ã¿ã«ã)ã„
qaranjkuno	ä¸‘é™‹,ä¸‘æ¶,éš¾çœ‹
podostvo	(å‘å±•,å‰è¿›)é“è·¯
bjlmj	çŸ¥å·±
uzakp#ska	å¤©æ¶¯,æè¿œå¤„ uzak-p#ska
tonalj	é‚»å±…,éš”å£,æ—è¾¹,ä¸´è¿‘,é™„è¿‘
yezjnsie	æŒæ¡,æ¶ˆåŒ–,é¢†ä¼š
cjnalna	æ­£å¼çš„,å®˜æ–¹çš„ cjn-alna  official
cjnaln@st	å®˜æ–¹æ€§è´¨,å®˜è…” Ğ¾Ñ„Ğ¸Ñ†Ğ¸Ğ°Ğ»ÑŒĞ½Ğ¾ÑÑ‚ÑŒ
pjerjeljet	è¿å¾™ Ğ¿ĞµÑ€ĞµĞ»Ñ‘Ñ‚ pjerje-ljet
arja	å’å¹è°ƒ Ğ°Ñ€Ğ¸Ñ
%aba	è›¤èŸ†,èŸ¾èœ
ume	ä¼š,èƒ½å¤Ÿ umçš„åŠ¨è¯
umeno	èƒ½åŠ›,æŠ€èƒ½ ÑƒĞ¼ĞµĞ½Ğ¸Ğµ
hejuasie	ä½¿å’Œè§£
hejuasiecev	(ç›¸äº’)å’Œè§£
enteo	æ­¦å™¨,å†›æ¢°,æ­¦è£…åŠ›é‡ en-te-o
entejche	æ­¦è£… Ğ²Ğ¾Ğ¾Ñ€ÑƒĞ¶Ğ¸Ñ‚ÑŒ
cykka	è¡£æ¶ Ğ²ĞµÑˆĞ°Ğ»ĞºĞ°
avtonomja	è‡ªæ²»æƒ
soghuknjatamakent	åŒ—äº¬(ç¼©ç•¥è¯:sokent)
tenimj	ä¸Šæµ·
jchna mongolia	å†…è’™å¤
kilolonge	é»‘é¾™æ±Ÿ
pr@sjolka	éœ€æ±‚ pr@s-jol-ka
poq#jka	ä¾›ç»™,ä¾›è´§,æä¾› po-q#j-ka
tontasjanaatamakent	å—äº¬(ç¼©å†™:tonkent)
harbjn	å“ˆå°”æ»¨
usto	è¿‡å»
esto	ç›®å‰
asto	ä»¥å
ajtcevno	è°“è¯­
sarina	é»„è‰²çš„ ÑĞ°Ñ€Ñ‹
%azka	ç»¿ Ğ¶Ğ°ÑÑ‹Ğ»
sor	ç°è‰² ÑÒ±Ñ€
dorudan	å‘æ¥,ä»æ¥ doru-dan
hbakle	å¿Œæƒ®,é¡¾å¿Œ,æ€• æ†š(ã¯ã°ã‹)ã‚‹
djem@n	æ¶é­”ğŸ‘¿Ğ´ĞµĞ¼Ğ¾Ğ½
ualyna	å,ä¸å¥½;æ¶æ€§;æ¶åŠ£;æœ‰å®³,ä¸åˆ©;è…è´¥çš„,åŠ£è´¨çš„
oksoke	æ£æµ‹,çŒœ(æµ‹),è‡†æµ‹ æ†¶æ¸¬(ãŠããã)
galaktjka	æ˜Ÿç³» Ğ³Ğ°Ğ»Ğ°ĞºÑ‚Ğ¸ĞºĞ°
ton	å›¢,å—
hoxjton	æ˜Ÿå›¢
hoxjbulut	æ˜Ÿäº‘
hoxjrj	æ˜Ÿæ²³
que	è¿½é€,é©±é€ Ò›ÑƒÑƒ
aqqu	å¤©é¹…Ğ°Ò›Ò›Ñƒ
anaua	é‚£ä¹ˆ
isi	è–„çº±,è–„ç‰‡
isina	æ·¡æ·¡çš„,è½»è–„çš„,æ˜“å¤±çš„
yetka+o	ç»éªŒ
%jdjek	æµ†æœ Ğ¶Ğ¸Ğ´ĞµĞº
#mut	æ¼©æ¶¡ Ğ¾Ğ¼ÑƒÑ‚
m@sal	ä¾‹å­ Ğ¼Ñ‹ÑĞ°Ğ»
focus	ç„¦ç‚¹ Ñ„Ğ¾ĞºÑƒÑ
focusq@le	ä½¿èšç„¦
focusq@lecev	èšç„¦äº
ha	åˆ€åˆƒ,åˆ€é”‹,åˆ€å£ ã¯
tenigokecev	è€¸ç«‹,ç«–ç«‹
oraza-ajt	å¼€æ–‹èŠ‚,è‚‰å­œèŠ‚ Ğ¾Ñ€Ğ°Ğ·Ğ° Ğ°Ğ¹Ñ‚
kurban-ajt	å®°ç‰²èŠ‚,å¤å°”é‚¦èŠ‚
dombra	å†¬ä¸æ‹‰ Ğ´Ğ¾Ğ¼Ğ±Ñ€Ğ°
rauap	çƒ­ç“¦æ™®
fakultjet	(å¤§å­¦é‡Œçš„)ç³» Ñ„Ğ°ĞºÑƒĞ»ÑŒÑ‚ĞµÑ‚
hat$@	ç§˜ä¹¦ hat-$@
%om@s	å·¥ä½œ Ğ¶Ò±Ğ¼Ñ‹Ñ
is	äº‹æƒ…
so$oton	ç¤¾å›¢
njanja	ä¿å§† Ğ½ÑĞ½Ñ
-lar	å¤æ•°åç¼€ åŒ…æ‹¬ç¬¬ä¸‰äººç§°åŠ¨è¯å¤æ•°åç¼€,æ³›æŒ‡æŸäº›
tok	æ—¶å€™ â€¦jn tok å½“â€¦æ—¶
kanjou	å®½æ•,å®½å®¹,å®¹è®¸,å®¹å¿
bi+ok	ä¾®è¾±
skjeljet	éª¨éª¼ ÑĞºĞµĞ»ĞµÑ‚ skeleton
kaljan	æ°´çƒŸ ĞºĞ°Ğ»ÑŒÑĞ½
quane	ä½¿é«˜å…´ Ò›ÑƒĞ°Ğ½Ñƒ
%oghar@na	é«˜ç­‰çš„ Ğ¶Ğ¾Ò“Ğ°Ñ€Ò“Ñ‹
#rn@	åœºæ‰€ Ğ¾Ñ€Ğ½Ñ‹
daghd@	æŠ€å·§ skill Ğ´Ğ°Ò“Ğ´Ñ‹
ojat	è€»è¾± Ò±ÑÑ‚, Ğ¿Ğ¾Ğ·Ğ¾Ñ€
%igit	ä¼™è®¡,guy Ğ¶Ñ–Ğ³Ñ–Ñ‚
ban	æ™š,æ™šä¸Š,å‚æ™š
hoj	ä¼š,é›†ä¼š,èšä¼š
banhoj	æ™šä¼š
dah	å±‹é¡¶ Ğ´Ğ°Ñ…
densekj	å…¸ç±,ä¹¦ç±
kejden	ç»ä¹¦,ç»å…¸(è‘—ä½œ)
poj	å¥æœ«è¯­æ°”è¯ â€¦ä¼¼çš„
jkse	æ’é™¤,ä½¿â€¦ä¾‹å¤–
jksostvo	æ’å¤–æ€§,æ’ä»–æ€§
jksostve	æ’å¤–,æ’ä»–
jchjkse	æ’å‡º,æ’æ³„
jchjksostve	æ’æŒ¤
tontaj	å›¢ä½“
$yudan	é›†å›¢ ã—ã‚…ã†ã ã‚“
ten%an	å¤©ç”Ÿ
ten%an@st	å¤©æ€§
fljpman	åŠ¨æ¼«
prjtendae	å…‹æœ overcome
uzune	ä¿æŒ,æŒç»­
uzunodekjna	å¯æŒç»­çš„
stjerva	æ··è›‹ ÑÑ‚ĞµÑ€Ğ²Ğ°
au	å–‚?(ç”µè¯ç”¨è¯­)
tsemjent	æ°´æ³¥ Ñ†ĞµĞ¼ĞµĞ½Ñ‚
kye$e	è¡—,å¤§è¡— ,ĞºÓ©ÑˆĞµ
ky$tina	å¼ºå£®çš„ Ò›Ò¯ÑˆÑ‚Ñ–
morgae	çœ¨çœ¼,çœ¨å·´ Ğ¼Ğ¾Ñ€Ğ³Ğ°Ñ‚ÑŒ
morgnue	çœ¨ä¸€ä¸‹çœ¼ Ğ¼Ğ¾Ñ€Ğ³Ğ½ÑƒÑ‚ÑŒ
bau@r	è‚ Ğ±Ğ°ÑƒÑ‹Ñ€
$pjlka	å‘ç°ª,æ’é”€ ÑˆĞ¿Ğ¸Ğ»ÑŒĞºĞ°
garantja	ä¿è¯ Ğ³Ğ°Ñ€Ğ°Ğ½Ñ‚Ğ¸Ñ
pomada	è† Ğ¿Ğ¾Ğ¼Ğ°Ğ´Ğ°
qara$@	ç›‘æ§æ‘„åƒæœº
pahae	è€•åœ° Ğ¿Ğ°Ñ…Ğ°Ñ‚ÑŒ
feda	æŒ‡å¤´
obman	éª—å±€ Ğ¾Ğ±Ğ¼Ğ°Ğ½
obmane	éª— Ğ¾Ğ±Ğ¼Ğ°Ğ½Ñ‹Ğ²Ğ°Ñ‚ÑŒ
makalestvo	æ–‡ä»¶
t@nda	å¬ Ñ‚Ñ‹Ò£Ğ´Ğ°Ñƒ
q@s	å†¬å¤© kÄ±ÅŸ Ò›Ñ‹Ñ
q@z	å¥³å­© Ò›Ñ‹Ğ·
quran	å¤å…°ç» Ò›Ò±Ñ€Ğ°Ğ½
qararang	é»‘è‰²,çœ¼ç›çš„é¢œè‰² Ò›Ğ°Ñ€Ğ°
bal@q	é±¼ balÄ±k Ğ±Ğ°Ğ»Ñ‹Ò›
#qu$@	å­¦ç”Ÿ Ğ¾Ò›ÑƒÑˆÑ‹
q#naq	å®¢äºº Ò›Ğ¾Ğ½Ğ°Ò›
qan	è¡€ Ò›Ğ°Ğ½
qudaj	å®‰æ‹‰,çœŸä¸»,èƒ¡å¤§ ÒšÒ±Ğ´Ğ°Ğ¹
sabaq	è¯¾lesson ÑĞ°Ğ±Ğ°Ò›
qoj	å€’ Ò›Ğ¾Ñ
qol	æ‰‹ Ò›Ğ¾Ğ»
qajt	è¿”å› Ò›Ğ°Ğ¹Ñ‚Ñƒ
q@z@kna	æœ‰è¶£çš„ Ò›Ñ‹Ğ·Ñ‹Ò›
biraq	ä½†æ˜¯ Ğ±Ñ–Ñ€Ğ°Ò›
qara	çœ‹ç€ look Ò›Ğ°Ñ€Ğ°
ernakim	ä»»ä½•äººÓ™Ñ€ĞºÑ–Ğ¼
eskjer	æˆ˜å£« Ó™ÑĞºĞµÑ€
jertjeng	æ˜å¤© ĞµÑ€Ñ‚ĞµÒ£
sjen	ç›¸ä¿¡ ÑĞµĞ½Ñƒ
ular	ä»–ä»¬ Ğ¾Ğ»Ğ°Ñ€
tavuk	é¸¡ Ñ‚Ğ°ÑƒÑ‹Ò›
ojun	æ¸¸æˆ Ğ¾Ğ¹Ñ‹Ğ½
kapju$on	å…œå¸½,é£å¸½(è¿å¸½å«è¡£çš„å¸½å­)ĞºĞ°Ğ¿ÑÑˆĞ¾Ğ½,ç½©
bjuro	å§”å‘˜ä¼š,å±€(bureau) Ğ±ÑÑ€Ğ¾
tuz	ç›(åœŸè€³å…¶è¯­tuz)Ñ‚Ò±Ğ·
berina	æ‰€æœ‰ Ğ±Ó™Ñ€Ñ–
til	è¯­è¨€,èˆŒå¤´, åœŸ:dil Ñ‚Ñ–Ğ»
tis	ç‰™ åœŸ:diÅŸ Ñ‚Ñ–Ñ
ming	åƒ Ğ¼Ñ–Ò£
pjjaz	æ´‹è‘± Ğ»ÑƒĞº onion Ğ¿Ğ¸ÑĞ·
tor	ç«™v. Ñ‚Ò±Ñ€Ñƒ
chorba	æ±¤ Ã§orba ÑĞ¾Ñ€Ğ¿Ğ°
mjeng	ç—£ Ğ¼ĞµÒ£
kal	èƒè®° Ò›Ğ°Ğ»
tab@l	æ‰¾ Ñ‚Ğ°Ğ±Ñƒ
bat@r	å‹‡å£« Ğ±Ğ°Ñ‚Ñ‹Ñ€
kamjyezljeto	çº¸é£æœº
tagajdje	äº¤æµ,äº¤è°ˆ tagaj-dje
kooj	è¡Œä¸º ã“ã†ã„
doruba	å¯¹æ–¹,å¯¹é¢
ychyn	ä¸ºäº†â€¦ for (åç½®prep.) smth. +ychyn ä¸ºäº†â€¦ Ò¯ÑˆÑ–Ğ½
isie	å˜æ·¡,æ·¡å¿˜
kje$je	æ˜¨å¤© ĞºĞµÑˆĞµ
jeka	å®¶åº­ä½œä¸š je-ka
euljet	æœä»£ Ó™ÑƒĞ»ĞµÑ‚
kirpi$	ç – ĞºÑ–Ñ€Ğ¿Ñ–Ñˆ ĞºĞ¸Ñ€Ğ¿Ğ¸Ñ‡
hal	çŠ¶å†µ Ñ…Ğ°Ğ»
kjjar	é»„ç“œ Ò›Ğ¸ÑÑ€
raj	æƒ…å†µ Ñ€Ğ°Ğ¹
auaraj	å¤©æ°” aua-raj  (Ğ°ÑƒĞ° Ñ€Ğ°Ğ¹Ñ‹)
bajauna	æ…¢çš„ Ğ±Ğ°ÑÑƒ
$ar$ae	ç´¯ ÑˆĞ°Ñ€ÑˆĞ°Ñƒ
ajdol	å¶åƒ
ajnala	å‘¨å›´ Ğ°Ğ¹Ğ½Ğ°Ğ»Ğ°
almort	æ¢¨ Ğ°Ğ»Ğ¼Ò±Ñ€Ñ‚
mar$	è¿›è¡Œæ›²  Ğ¼Ğ°Ñ€Ñˆ
onate	ä¸­æ„,åçˆ±äº Ò±Ğ½Ğ°Ñ‚Ñƒ
edjebjet	æ–‡å­¦ Ó™Ğ´ĞµĞ±Ğ¸ĞµÑ‚
tyjye	éª†é©¼ğŸ« Ñ‚Ò¯Ğ¹Ó©
bj	æ³•å®˜ Ğ±Ğ¸
suje	æ¨,æ¨è¿›,æ¨åŠ¨ ã™ã„
hje	æ‹‰,ç‰µå¼•,æ‹½ å¼•(ã²)ã
qoldae	æ”¯æŒ Ò›Ğ¾Ğ»Ğ´Ğ°Ñƒ qol-da-e
handae	åå¯¹ ã¯ã‚“ãŸã„
bjlee	è·³èˆ Ğ±Ğ¸Ğ»ĞµÑƒ
yezsjn	ä½ è‡ªå·±
yezsjnjz	ä½ ä»¬è‡ªå·±
yezjz	æˆ‘ä»¬è‡ªå·±
yezlar	ä»–ä»¬è‡ªå·±
yezstvo	æ€§è´¨,ç‰¹æ€§ ÑĞ²Ğ¾Ğ¹ÑÑ‚Ğ²Ğ¾
fjeja	ä»™å¥³ Ñ„ĞµÑ
ad	åœ°ç‹± Ğ°Ğ´
jad	æ¯’,æ¯’ç´  ÑĞ´
komok	å›¢,å°çƒ ĞºĞ¾Ğ¼Ğ¾Ğº
Qazaqstan	å“ˆè¨å…‹æ–¯å¦ ÒšĞ°Ğ·Ğ°Ò›ÑÑ‚Ğ°Ğ½
Fransja	æ³•å›½
Tyrkja	åœŸè€³å…¶
Hankinj	éŸ©å›½
Anglja	è‹±æ ¼å…°,è‹±å›½
Mongolja	è’™å¤
Tajkinj	æ³°å›½
Germanja	å¾·å›½
Jtalja	æ„å¤§åˆ©
Austrja	å¥¥åœ°åˆ©
Australja	æ¾³å¤§åˆ©äºš
Kanada	åŠ æ‹¿å¤§
Pakjstan	å·´åŸºæ–¯å¦
Hjndustan	å°åº¦
%ana zjelandja	æ–°è¥¿å…°
Jspanja	è¥¿ç­ç‰™
Portugalja	è‘¡è„ç‰™
Brazilja	å·´è¥¿,å·´è¥¿åˆ©äºš
jamaj	ç–¾ç—… ã‚„ã¾ã„
najamj	çƒ¦æ¼ æ‚©(ãªã‚„)ã¿
tonbo	èœ»èœ“ èœ»è›‰(ãƒˆãƒ³ãƒœ)
jnago	è—è™«,èš‚èš± è—(ã„ãªã”)
jne	ç¨»å­,æ°´ç¨»
jnazima	é—ªç”µâš¡ ç¨²å¦»(ã„ãªãšã¾)
jnaho	ç¨»ç©—
kakj	èŠ±å‰ğŸŒ¸,èŠ±è‰ ã‹ã
partja	å…š Ğ¿Ğ°Ñ€Ñ‚Ğ¸Ñ
kompartja	å…±äº§å…š ĞºĞ¾Ğ¼Ğ¿Ğ°Ñ€Ñ‚Ğ¸Ñ
kojl	çº¿åœˆ coil
chjgaj	å·®å¼‚,å·®åˆ«,åŒºåˆ«,ä¸åŒ é•(ã¡ãŒ)ã„
djf	å¾®åˆ†
oe	åå«
djake	æ„Ÿè°¢,è°¢è°¢
huangdja	å¸å›½
huangdj	çš‡å¸
muaro	é›¶
muarocj	è´Ÿæ•°,è´Ÿ
hrjeste	æ²»ç–—,ç–—ä¼¤
kyezdae	ç„å‡†
guuzen	å¶ç„¶ ãã†ãœã‚“
ejkjou	å½±å“,ä½œç”¨ å½±éŸ¿(ãˆã„ãã‚‡ã†)
cejkjou	å·§åˆ,ä¸€è‡´ coincidence
sla	å¯„,å‘å‡º,æ´¾(ÑĞ»Ğ°Ñ‚ÑŒ)sent
yetvoddan	ç”Ÿäº§,åˆ¶é€ 
slauako	æ´¾ç”Ÿè¯
slauake	æ´¾ç”Ÿ
cjok	ç›´ ã¡ã‚‡ã
cjoksauaq	ç›´æ¥åœ°,æ²¡æœ‰å…¶ä»–äº‹ç‰©ä»‹å…¥åœ°
cjoksauao	ç›´æ¥,ç‡ç›´
cjoksauana	ç›´æ¥çš„,ä¸æ‹å¼¯æŠ¹è§’çš„
cjoksen	ç›´çº¿ ç›´ç·š(ã¡ã‚‡ãã›ã‚“)
cjokrog	ç›´è§’
atama$@	è€æ¿,é¢†å¯¼
torcjna	å‡çš„
torcjsyez	è°è¨€
yanljna	è‰³ä¸½çš„
zang$@	å¾‹å¸ˆ
hanhana	é¤å…
ejona	ç–¼çš„
j	å™«
#	å­—æ¯,å‘éŸ³É”,ç¯
ye	åœ
i	å··å­
@	å­—æ¯,å‘éŸ³É™,æƒŠè®¶
ba	çš®
be	æ°å¼€
bju	å°„å‡»
hjkome	æ€§åˆ«
za%an	æ€§
ze	è‰¹
moto	åŸæ¥,æœ¬æ¥,æºå¤´ å…ƒ(ã‚‚ã¨)
zajtka	æ ‡é¢˜
hatslana	é€šç•…çš„,é€šè¾¾çš„,é¡ºåˆ©çš„
buguku$	å¸ƒè°·é¸Ÿ
tu	è‡ªé€ è¯,ä¸€ç™¾
tuajak	èœˆèš£
jyzstvo	æ ·å¼
jyzstvojzm	å½¢å¼ä¸»ä¹‰
cjnaljzm	å®˜åƒšä¸»ä¹‰
$o	æ²‰é‡
$ona	é‡çš„
$osctvo	é‡è¦æ€§
$osctvona	é‡è¦çš„
daljtas	å¤§ç†çŸ³
ajleyn	é—¨é“ƒ
mu	æœ¨å¤´
muka	çŒæœ¨
$u	åšç¡¬
$una	ç¡¬çš„
$ukida	åšæœ
mo	æŸ”è½¯
mona	æŸ”è½¯çš„
juna	ç®€å•çš„
gagaka	é¸­å­
kalako	è¾£å­
guzunu	é¸½å­
tsazasa	é¹°
ator	å…³éš˜,å…³å¡
imjator	æµ·å…³
katahoj	å¤§ä¼š
tsa	å°†å†›
ma	è¢«æ”¾å¼ƒçš„(äº‹ç‰©)
mae	æ”¾å¼ƒ
njngm@ng	æŸ æª¬
qaitajte	å›å¤
tsetse	éœ€è¦
anka$@lar	è§‚ä¼—
choe	éª‘
yezcho	è‡ªè¡Œè½¦
$@n	è‚¾
kuato	ç¥
kuatosjzzm	æ— ç¥è®º
kuatosjzist	æ— ç¥è®ºè€…
cho$@	éª‘æ‰‹
cjjaze	ç­¾
kyermono	è¯æ˜
cjazkyer	ç­¾è¯
cjazkyersjz	å…ç­¾
siqe	ä¹ æƒ¯,æƒ¯äº
mabuna	è€€çœ¼çš„
areste	åº”è¯¥å­˜åœ¨,è¡¨æ¨é‡,æ„å¿—
-ste	åŠ¨è¯åç¼€,è¡¨æ¨é‡,æ„å¿—(åº”è¯¥æ˜¯â€¦/æƒ³å¿…æ˜¯â€¦)
umo-	å‰ç¼€,èƒ½â€¦
mumo-	å‰ç¼€,ä¸èƒ½â€¦
duche	è£
duch$@	è£ç¼
zhe	æ²»ç†,ç®¡ç†
zho	æ²»ç†,ç®¡ç†
ho	è¾¹,ç•Œé™
hose	é™åˆ¶
hosostvo	åˆ¶è£
vo	æ¸©åº¦
tanavo	ä½“æ¸©
auavo	æ°”æ¸©
vochjgaj	æ¸©å·®
vomono	æ¸©åº¦è®¡
vohana	æ¸©å®¤
yetujucev	ç¡é†’
ch@e	åµé†’,å«é†’,å”¤é†’,æ¿€èµ·
ch@mono	é—¹é’Ÿ
ybo	é•œå­
tsjklon	æ°”æ—‹
@ne	å°
@no	å°ç« 
hode	ç¬‘
nae	å“­ æ³£(ãª)ã
zaare	å‡ºç°
artenhe	å æ®
artenhecev	å¿™,å¿™äº
artenhecevna	å¿™ç¢Œçš„
mudokistvona	ç‰¹æ®Šçš„,ç‰¹åˆ«çš„
dokistvona	æ™®é€šçš„,ä¸€èˆ¬çš„
qansosena	å‰¥å‰Šçš„,å¸è¡€çš„
sose	å¸,ÑĞ¾ÑĞ°Ñ‚ÑŒ
uke	åå‡º,å‘¼å‡º(æ°”ä½“ç­‰)
sazjna	è„çš„(anq$umaè¯­)
@ngara	æµæ˜Ÿ(å¤anq$umaè¯­)
cava	å¾®é£ (anq$umaè¯­)
kamljna	ç–¯ç‹‚çš„(anq$uma è¯­)
atjchta	è£è€€(anq$uma è¯­)
pamljq	å°æºª(anq$uma è¯­)
+age	è‹é†’ (anq$uma è¯­)
ajstra	ç›®æ ‡(anq$umaè¯­)
saqtjna	ç ´ç¢çš„(anq$uma è¯­)
ancjlla	å¥³ä»† æ‹‰ä¸è¯­
kazka	é£è½¦
tastenostvo	é˜¶çº§
gong	æ±,æ°´é“¶
kej	è‚Œ
hoe	è€—
suanna	é…¸
cyn	ç¾¤
uej	èƒƒ
kega	ä¼¤,ä¼¤å£,åˆ›ä¼¤
reket	è®¹è¯ˆ,å‹’ç´¢ racket
kataynna	å“çš„
kataynka	éŸ³å“
argon	æ°©
+jkano	æŠ¥çº¸
+jkane	è®¡æ—¶,æŠ¥æ—¶
cjraghba$nja	ç¯å¡”
lakuna	ç©ºéš™,ç©ºç™½ Ğ»Ğ°ĞºÑƒĞ½Ğ°, lacuna
kjlae	é—ªçƒ ã‚­ãƒ©ã‚­ãƒ©âœ¨
vodka	ä¼ç‰¹åŠ 
tillargaki	è¯­è¨€å­¦
mjere	æµ‹é‡
zangmjerna	åˆç†çš„,åˆä¹è§„å¾‹çš„
zangmjern@st	è§„å¾‹æ€§,åˆç†æ€§
makjja%	åŒ–å¦† Ğ¼Ğ°ĞºĞ¸ÑĞ¶
zenmjr	å…¨ä¸–ç•Œ,å…¨çƒ,ç¯çƒ
zemjosenka	å› ç‰¹ç½‘,äº’è”ç½‘
burjabjlmono	æµ·ç‡• Ğ±ÑƒÑ€ĞµĞ²ĞµÑÑ‚Ğ½Ğ¸Ğº
tyrk	çªå¥(â€œç‹„/ç¿Ÿâ€)
tyr	Ñ‚Ò¯Ñ€ç±»,ç§ç±»,ç›¸è²Œ,æ ·å­(â€œç¿Ÿâ€)
tyk	æ¯› Ñ‚Ò¯Ğº (å¤æ±‰è¯­â€œç¿Ÿâ€)
taq	æ°å¥½,åˆšå¥½(å¤æ±‰è¯­â€œé©â€) Ñ‚Ğ°Ò›
taqae	Ñ‚Ğ°Ò›Ğ°Ñƒ æ¥è¿‘("é©â€)
t@n	æ°”æ¯,å–˜æ°” Ğ´ĞµĞ¼ ("å¡«")
t@ne	å‘¼å¸,å–˜æ°”
zrje	æˆç†Ÿ,å‘è‚²æˆç†Ÿ Ğ·Ñ€ĞµÑ‚ÑŒ
mjo	æ°´è·¯,æ°´é“,èˆªé“ æ¾ª(ã¿ãŠ)
jyanjang	é¸³é¸¯
moudan	ç‰¡ä¸¹ ä¸­å¤å‘éŸ³
yelsie	æ€,æ€æ­»
cjajjnko	èŠ±ç”Ÿ
sotokinj$@	å¤–å›½äºº
hjlbase	å‹æ¦¨,å‰¥å‰Š,å‹è¿«
hjlbasba	ä¼ä¸š
dekjbolq	å¯èƒ½,ä¹Ÿè®¸
yse	ä½¿â€¦åœæ­¢
hjtarmono	æƒåˆ© hjt-ar-mono
njerv	ç¥ç» Ğ½ĞµÑ€Ğ²
suslana	æµåŠ¨çš„
suslan@st	æµä½“,æ±,æ¶²ä½“
entor	åœç•™
opjeko	ç›‘æŠ¤,ç…§é¡¾ Ğ¾Ğ¿ĞµĞºĞ°
opjeke	ç›‘æŠ¤,ç…§é¡¾ Ğ¾Ğ¿ĞµĞºĞ°Ñ‚ÑŒ
alopjekocje	al-opjeko-cj æ”¶å…»
paue	æŒæƒ,ç»Ÿæ²»
pauo	pauo ç»Ÿæ²»
%al@qpauo	æ°‘ä¸»
san-	å‰ç¼€,è¡¨åˆ†æ•£
sanpode	æ•£æ­¥
kjelmade	æ”¶å…¥
sankjele	èŠ±é”€,å¼€é”€,å¼€æ”¯,æ”¯å‡º
zagadka	è°œè¯­
sangadka	è°œåº•
nakakj	ä¸­ç§‹èŠ‚
jxxjona	å…±åŒçš„
katanje$jeq	ç›¸å½“,æœ‰ä¸€å®šç¨‹åº¦åœ°
trebe+ena	æ‰€è¦æ±‚çš„
trebe+eno	è¦æ±‚
trebe	è¦æ±‚â€¦â€¦
stres	å‹åŠ›
tara	å¼¦
prjnur	é»æ˜
Tentau	å¤©å±±
otsk	åŒ…,èƒŒåŒ…
men	æ„æ€
menstvo	æ„ä¹‰
mene	æ„æ€æ˜¯,æ„å‘³ç€
chue	ç¬ƒä¿¡,ä¿¡å¥‰,å´‡æ‹œ
chukuatzm	å®—æ•™
marksjzm	é©¬å…‹æ€ä¸»ä¹‰
so$oaljzm	ç¤¾ä¼šä¸»ä¹‰
komvodjzm	å…±äº§ä¸»ä¹‰
hanaqan	é¼»è¡€
zh@	æŸ¿å­( ä¸­å¤éŸ³)
q@z@lzh@	è¥¿çº¢æŸ¿ğŸ…
djas	è–¯(ä¸Šå¤éŸ³)
guas	èŠ‹(ä¸Šå¤éŸ³)
cjenjaguas	åœŸè±†,é©¬é“ƒè–¯
tangtang	è¹„å­ (æ‹Ÿå£°è¯)
bihjtchuo	ä¸ªäººå´‡æ‹œ
vjrus	ç—…æ¯’
maska	å£ç½©ğŸ˜·
luno	é˜´å†,æœˆäº®å† luna
til$@	è®°è€…
kitapje$@	ä¹¦è®°
-njz	ç¬¬äºŒäººç§°åç¼€(å¤æ•°)
-+e	åŠ¨è¯è¢«åŠ¨åç¼€
-s	åŠ¨è¯ä½¿åŠ¨
mardaspant	æˆåˆ†,å…ƒç´ (ç²Ÿç‰¹è¯­)
ordu	å†›é˜Ÿ åœŸ<åŒˆå¥´
xjmnu	é¬¼(ç²Ÿç‰¹è¯­)
le$p	ç²˜æ¶²,é»æ¶² (åç«ç½—è¯­)
anchman	ç¤¾å›¢(ç²Ÿç‰¹è¯­)
mar	å…ˆç”Ÿ(å¤ä»£å™åˆ©äºšè¯­)
mjdjk	ä¿—äºº (ç²Ÿç‰¹è¯­)
patghamuar	å…ˆçŸ¥(ç²Ÿç‰¹è¯­)
sukauatj	è¥¿æ–¹æä¹ä¸–ç•Œ(æ¢µè¯­)
$lok	è¯—å¥(æ¢µè¯­)
$arjr	èˆåˆ©(éª¨)(æ¢µè¯­)
xyk	é™æ­¢(ç²Ÿç‰¹è¯­)
wjhar	å¯ºåº™(æ¢µè¯­)
zautaj	å‘éŸ³(å¤å™åˆ©äºšè¯­)
xjx	çƒ¤è‚‰é’å­,çƒ¤è‚‰ç­¾ ÅŸiÅŸ
samixyk	å†·é™,é•‡é™
katorga	è‹¦å½¹ ĞºĞ°Ñ‚Ğ¾Ñ€Ğ³Ğ°
mjdna	ä¿—çš„
zautaje	å‘éŸ³
njemna	å“‘çš„ Ğ½ĞµĞ¼Ğ¾Ğ¹
le$pe	ç²˜,é»,è´´
le$pna	é»çš„,ç²˜çš„
sanle$pe	å¼ è´´
njeon	æ°–,éœ“è™¹
satka	è´­ç‰©
debjerka	è´¹ç”¨
zenpokinje	å‡è®¾
yetbjere	å–
chuma	é¼ ç–«,é»‘æ­»ç—… Ñ‡ÑƒĞ¼Ğ°
atame	é¢†å¯¼,ç»Ÿé¢†
gnue	å¼„å¼¯,æ°å¼¯ Ğ³Ğ½ÑƒÑ‚ÑŒ
njeme	å˜å“‘,è¯´ä¸å‡ºè¯ Ğ½ĞµĞ¼ĞµÑ‚ÑŒ
ubj	ç‰¹æ®Šç–‘é—®è¯ å“ªé‡Œ where æ‹‰ä¸è¯­
kalinna	åšçš„,kalÄ±n
islakna	æ¹¿çš„
map@	å…¬æ–‡å¤¹,æ–‡ä»¶å¤¹ (å¾·:mappe)
azse	ä½¿å‡å°‘
dala	ç²—æš´,çŒ›çƒˆ
lajo	åœ°å½¢
apostrof	æ’‡å·â€œâ€™â€ (apostrophe,Ğ°Ğ¿Ğ¾ÑÑ‚Ñ€Ğ¾Ñ„)
syezanalna	é€å­—é€å¥åœ°
masa	æ¡Œå­ masa
bo$na	ç©ºçš„
darna	çª„çš„,ç´§çš„
kari	å¦»å­ karÄ±
tavan	å¤©èŠ±æ¿ tavan
saat	å°æ—¶
sanjye	ç§’ saniye
avlae	æŠ“æ•,çŒæ•  avlamak Ğ°ÑƒĞ»Ğ°Ñƒ
bjte	ç»“æŸ bitmek
kalke	èµ·æ¥
bjne	ä¹˜ä¸Š,ä¹˜å,éª‘ä¸Š,go on, binmek
alka	è´¿èµ‚ al-ka
dale	è›®å¹²
kjkj	æœºå™¨
tagajajte	äº¤æµ
%udan	æ´—æ¸…
kotjol	é”… ĞºĞ¾Ñ‚Ñ‘Ğ»
-ex	ç¬¬äºŒäººç§°åç¼€
-ao	åŠ¨è¯å‘½ä»¤å¼
-nue	åŠ¨è¯åç¼€,è¡¨ä¸€æ¬¡(Ğ½ÑƒÑ‚ÑŒ)åæ¥æ—¶æ€,äººç§°
judej	çŠ¹å¤ªäºº Ğ¸ÑƒĞ´ĞµĞ¹
caj$o	èŒ¶è¯ä¼š(caj-j$o)
$anta%	æ•²è¯ˆ,å‹’ç´¢ ÑˆĞ°Ğ½Ñ‚Ğ°Ğ¶ (æ¥è‡ªæ³•è¯­)
$anta%q@le	æ•²è¯ˆ,å‹’ç´¢
olopos	æ¤…å­ Ğ¾Ğ»Ğ¾Ğ¿Ğ¿Ğ¾Ñ (é›…åº“ç‰¹)
suslanare	æ¶²åŒ–çš„
xjebjen	ç¢çŸ³,çŸ³å­ Ñ‰ĞµĞ±ĞµĞ½ÑŒ,Ñ‰ĞµĞ±Ñ‘Ğ½ĞºĞ°
asfalt	æ²¥é’ Ğ°ÑÑ„Ğ°Ğ»ÑŒÑ‚
kyepotena	å¤šé¢çš„,å¤šå…ƒçš„ kyep-potenn@st
jo	å…¶ä»–,ä½™ä¸‹,å…¶ä½™
#tjhj	ç«å±±
hejua@kjean	å¤ªå¹³æ´‹
tortenanlo	çœŸç†
ne	å“ªä¸ª
anauda	é‚£é‡Œ
buda	åœ¨è¿™,è¿™é‡Œ
pj	çš®,å•ä½,1e-12
nano	çº³,å•ä½,1e-9
vj	å¾®,å•ä½,1e-6
hao	æ¯«,å•ä½,1e-3
lj	æ,æå­,æå­æ ‘,å˜(1e-2)
hon	åˆ†,å•ä½,1e-1
tymen	ä¸‡(é˜¿å°”æ³°è¯¸è¯­)
mjljon	ç™¾ä¸‡
tonaljno	é™„å¸¦å“,é™„å½•
tabu	ç¦å¿Œ tabu Ñ‚Ğ°Ğ±Ñƒ
hjtbal@q	äººé±¼
kyepkuatzm	å¤šç¥æ•™
dokikuatzm	ä¸€ç¥æ•™
kjostvo	è‰¯çŸ¥,è‰¯å¿ƒ
kjostvosjzna	æ— è€»çš„
ortona	æ­£ç¡®çš„ ortho-
ortojazo	æ­£å­—æ³•
nakana	ä¸­é—´çš„,ä¸­å¿ƒçš„
nakan@st	ä¸­å¿ƒåº¦,ä¸­å¿ƒæ€§
nakanose	ä½¿é›†ä¸­
nakanosjzm	ä¸­å¤®é›†æƒ
yezosta	ä¸“åˆ¶
sujn	æ°´ä½“
sanb&lcjo	åˆ†éƒ¨,æ”¯éƒ¨
hanpokinjna	å¯¹ç«‹çš„,çŸ›ç›¾çš„ op-posite
nakabjlo	æ„è¯†:con-sci-ous
nakabjlcjo	æ½œæ„è¯† sub-conscious
%argon	è¡Œè¯
jnna	å¤§å®¹é‡çš„
jnn@st	å®¹é‡
hokent	éƒŠåŒº
jxxjotoro	ç³»ç»Ÿ
kynna ixxjotoro	å¤ªé˜³ç³»
aua$ar	å¤§æ°”,æ°”æ°›
slojlar nj aua$ar	å¤§æ°”å±‚
ankaq@le	ä»¤â€¦è¿·æ‹,è¯±æƒ‘
ortoatjchta	ä¸œæ­£æ•™
kjelbjero	ææ¬¾
kjel%anatsja	åˆ›æ–°
o	åå­—(åœŸè€³å…¶è¯­ad,æ¥è‡ªå¤æ±‰è¯­â€œæ›°â€)
ate	è·³è·ƒ(atla-, æ¥è‡ªå¤æ±‰è¯­â€œè¶Šâ€)
tanimek	ç›¸è¯†,è®¤è¯†(tanÄ±makæ¥è‡ªå¤æ±‰è¯­â€œçŸ¥â€)
var	è´¢å¯Œ,è´¢äº§,æºäºå¤æ±‰è¯­â€œå¯Œâ€
kap	å®¹å™¨å™¨çš¿,ç¢—ç¢Ÿç›˜é’µç›† æ¥è‡ªå¤æ±‰è¯­"ç›’"
kapan	å¸­å­,è‰å¸­,æ¥è‡ªå¤æ±‰è¯­â€œè“‹â€
kabuk	å£³(å¤æ±‰è¯­â€œè“‹â€)
djke	ç«–,ç«‹,æ’,æ ½ç§,ç§æ¤,æºäºå¤æ±‰è¯­â€œæ¤â€
tjke	ç¼â€œå¤æ±‰è¯­ ç´© â€
djkna	ç›´çš„
djzgjne	åˆ¶æ­¢,æŠ‘åˆ¶,æºäºå¤æ±‰è¯­â€œçµ·â€
elebele	èƒ¡è¯´å…«é“,å–‹å–‹ä¸ä¼‘,å½å½å–³å–³
pjencyane	è°ä¼ ,é—²èŠ
sotorjimj	å¤–æ±‡
katoljka	å¤©ä¸»æ•™ ĞºĞ°Ñ‚Ğ¾Ğ»Ğ¸ĞºĞ°
yetsusla	æµ·å³¡
zasusla	æµ·æ¹¾
ake	é¢†å¯¼,ç‡é¢†,ç»Ÿé¢† (åç«ç½— )
kasuna	è‰¯å¥½,ä¼˜ç§€(åç«ç½—)
klju	åèª‰,åå£°(åç«ç½—)
kiljme	æ–¹å‘(åç«ç½—)
j@rk	å´‡æ•¬ reverence(åç«ç½—)
nam	é èº¬,å°Šæ•¬,è‡´æ•¬ (åç«ç½—)
jxxjoja	å…¬ç¤¾
varjn	åœ°ä¸»
cjkasucjmono	é›ªè²
ljpa	æ¤´æ ‘
suyeto	è¾“æ°´ç®¡é“
sukjeto	æ’æ°´ç®¡é“
santvorjo	æº¶å‰‚
kyep%ej	ç™½ç™½åœ°,å¾’ç„¶
enjyztvorje	ä½¿æ‹ŸäººåŒ–
koda	äº²å®¶
Cjnja	ä¸­å›½
Tencja	å¤©æœ,å¤©ä¸‹,ä¸­å›½(çš„é›…ç§°)
Etau	æ±Ÿå±±,ä¸­å›½(çš„é›…ç§°)
han	é¥­,é£Ÿç‰©,å¯æ±—,æ±‰æ—
delamjse	å‘ç°
tenanka	ç›‘è§†
yen	å‰,Ã¶n
yentore	é¢ä¸´
hjdanna	æŠ½è±¡çš„ hj(e)-dan-e
yensla	å‰æ
aljumjnj	é“ Ğ°Ğ»ÑĞ¼Ğ¸Ğ½Ğ¸Ğ¹
kamotsimaualj	å•†å“æµè½¬ Ñ‚Ğ¾Ğ²Ğ°Ñ€Ğ¾Ğ¾Ğ±Ğ¾Ñ€Ğ¾Ñ‚
kirsuae	è¿›å£
kjetsuae	å‡ºå£
kjetsua$@	å‡ºå£å•†
kirsua$@	è¿›å£å•†
brimono	åˆ®åˆ€
asmanbrimono	æ‘©å¤©å¤§æ¥¼ skyscraper Ğ½ĞµĞ±Ğ¾ÑĞºÑ€ĞµĞ±
sanqoje	å®‰æ’,å¸ƒç½®,å¤„ç†
dokise	ç»Ÿä¸€
trjdokis	ä¸‰ä½ä¸€ä½“
$kala	åˆ»åº¦,ç­‰çº§ (ä¿„,å¾· ÑˆĞºĞ°Ğ»Ğ°)
soto$kalaq@le	ä½¿â€¦è¶…é¢
djljnstvo	å®—æ•™ç•Œ
kamotsi$@	å•†äºº,ä¹°å–äºº
torg	äº¤æ˜“ Ñ‚Ğ¾Ñ€Ğ³
sat$@	ä¹°ä¸»
sat$@stvo	å•†ç•Œ
dvormono	å®«æ®¿
dvor	åº­é™¢ Ğ´Ğ²Ğ¾Ñ€
dvorjn	è´µæ—
dvorjnstvo	è´µæ—é˜¶å±‚
+jkanjxxjona	ç°ä»£çš„,å½“ä»£çš„
tsaj	èœ
aqtsaj	ç™½èœ
bardak	æ¯å­
huak	ç¡… (ä¸­å¤éŸ³)
-tagaje	åŠ¨è¯çš„ç›¸äº’æ€åç¼€
Europa	æ¬§æ´²
Asja	äºšæ´²
%al@kja	å…±å’Œå›½,æ°‘å›½,æ°‘ä¸»å…±å’Œå›½
pokjzi+eno	æœºæ„,ç»„ç»‡
pokjzi+eno nj dokis+ena kinjlar(PDK)	è”åˆå›½
Pol$a	æ³¢å…°
Vengrja	åŒˆç‰™åˆ© Ğ’ĞµĞ½Ğ³Ñ€Ğ¸Ñ
jxxjostvona	ä¸€æ ·çš„,ç›¸åŒçš„,ç›¸ç­‰çš„
cjftjxxjona	å¯¹æ¯”çš„
cjftjxxjo	å¯¹æ¯”
arman	å¸Œæœ›,æ¢¦æƒ³,å¹»æƒ³
ymjxxjo	åŒå¿—
ymjxxjostvo	å›¢ä½“,ç»„ç»‡,åŒå¿—å…³ç³»
anaekje	çˆ¶æ¯,åŒäº²
Dokis+ena kinj nj Amjerjka	ç¾åˆ©åšåˆä¼—å›½
Amjerjka	ç¾æ´²,ç¾å›½
@kjeanja	å¤§æ´‹æ´²
Engtontasestja	å—ææ´²
zal	å¤§å… Ğ·Ğ°Ğ»
cjzal	åœ°ä¸‹å®¤
sannou+e	(æ‰‹æœºç­‰ç”µå­äº§å“)æ²¡ç”µ
ljetka	é£è¡Œå™¨
%ol$@stvo	æ—…è¡Œ yolculuk
bavul	æ—…è¡Œç®± bavul
jene	æ¼”
tenjene	è¿›åŒ–,å¤©æ¼”
Cjnjstan	éœ‡æ—¦,(å¤ä»£è¥¿åŸŸå„å›½å¯¹ä¸­å›½çš„ç§°å‘¼)
aetena	è‡³é«˜çš„,ç¥åœ£çš„,åœ£æ´çš„
fjljpje	éª„å‚²
wekon	ç‹¡çŒ¾,é˜´é™©
feand	æš´èº,ç„¦èº
jazva	æºƒç–¡ ÑĞ·Ğ²Ğ°
Sjbjr	è¥¿ä¼¯åˆ©äºš Ğ¡Ğ¸Ğ±Ğ¸Ñ€ÑŒ
Sjbjrjazva	ç‚­ç–½ ÑĞ¸Ğ±Ğ¸Ñ€ÑĞºĞ°Ñ ÑĞ·Ğ²Ğ°
tjfa	ä¼¤å¯’ Ñ‚Ğ¸Ñ„Ğ°
enluco	è¾å°„,ç…§å°„
kjelsusla	æ½®
luc	å…‰çº¿ Ğ»ÑƒÑ‡
haeseue	åˆ†è£‚,åˆ†ç¦»,åˆ†è§£,è§£ç¦»
sjvo	äº¤å“ä¹
ytyk	ç†¨æ–— ÑƒÑ‚ÑĞ³â¬…ï¸Ò¯Ñ‚Ò¯Ğº
$aht	çŸ¿ ÑˆĞ°Ñ…Ñ‚Ğ°â¬…ï¸(å¾·)der Schacht
agat	ç›ç‘™ Ğ°Ğ³Ğ°Ñ‚â¬…ï¸der Agat
nataso	éª‘å£«
ljgaki	å“²å­¦(ä¸¥å¤:ç†å­¦)
cyngaki	ç¤¾ä¼šå­¦(ä¸¥å¤:ç¾¤å­¦)
yezaq	è‡ªç™½
+jt	å…¶å®
litmektep	å°å­¦
nakamektep	ä¸­å­¦,åˆä¸­
%oghar@mektep	é«˜ä¸­
anavar	èµ„æœ¬
bufoleo	ä¸­ä¸“
aljnge	æ¼‚æµ®,æ‚¬æµ®
hydro	é‡‘å­—å¡”
doglo	(ç²¾ç¥)é¢†è¢–,å¼•é¢†è€…
kloso	äººå¶,æ‰‹åŠ,(äº‹ç‰©çš„)æ¨¡å‹
vjnso	äº¡çµ,äº¡é­‚,å¹½çµğŸ‘»
lontado	è½»éŸ³ä¹,æµè¡ŒéŸ³ä¹
bendo	(å¤©ä¸»æ•™)æ•™çš‡,æ•™å®—
uno	è¿æ°”,æ°”è¿ ã†ã‚“
kov$	é•¿æŸ„é”…
vjto	å…ˆé”‹,å…ˆè¡Œè€…
bahjla	é‹å¥—
sjeld	é²±é±¼
kouajnka	ä¿é™©
zasjele	å…¥ä½
sohja	å¦–ç²¾,ç²¾çµ
kato	æ•…ä¹¡,æ•…é‡Œ
kljnjka	é™„å±åŒ»é™¢
poljkljnjka	è¯Šæ‰€
gospjtal	å†›åŒ»é™¢
bjerdanka	é›¶é’±
pjtsa	æŠ«è¨
islaka	ç—°
vaktsjna	ç–«è‹—
vaktsjnatsja	æ¥ç§
sjertjfjkat	å‡­è¯
tamagomono	ç…è›‹ğŸ³
jndjejka	ç«é¸¡è‚‰
djveno	å‚è€ƒ,å‚ç…§ç‰©
luce	(è‡ªç„¶)å…‰ç…§,æ™’
luco	(æ™’çš„)å¹²,å¹²ç‰©
mango	èŠ’æœ
mangluco	èŠ’æœå¹²
yzymluco	è‘¡è„å¹²
palje	ç‚¹(ç«),çƒ§,ç‡
tenpaljo	ç‚ç—‡
test	æ£€æµ‹,æµ‹è¯•
eje	ç–¼
Grjekja	å¸Œè…Š
kurs	æ±‡ç‡
buasto	åé¢çš„(ä¸œè¥¿),åç»­
bazoq	ä¹‹å
torcje	å‡è£…,ä¼ªè£…
sla%ane	(äº‹ä»¶)å‘ç”Ÿ,(é—®é¢˜)äº§ç”Ÿ
%ana$@	æ–°äºº,æ–°æ‰‹,æ–°ç”Ÿ
%utane	æ´—æ¾¡ğŸ›€
zanoue	ç»™â€¦å……ç”µ
zanouka	æ’å¤´
culok	(å¥³)é•¿ä¸è¢œÑ‡ÑƒĞ»Ğ¾Ğº
lo$ka	å‹º
cajna lo$ka	èŒ¶åŒ™ Ñ‡Ğ°Ğ¹Ğ½Ğ°Ñ Ğ»Ğ¾Ğ¶ĞºĞ°
sous	é…±
palov	æŠ“é¥­
lahman	æ‹Œé¢
hantenpaljna dorj	æ¶ˆç‚è¯
ka$lja	å’³å—½
pjero	ç¾½æ¯›
pjere	â€¦â€¦å‘ç—’
jnkola	å±…æ°‘ æ‹‰ä¸è¯­
agrjkola	å†œå¤«,å†œæ°‘ æ‹‰ä¸è¯­
sjnhro-	å‰ç¼€,è¡¨åŒæ­¥,åŒæ—¶ synchro-
sjnhronjst	åŒå£°ä¼ è¯‘
njobo	ä¸Šé¢š
$aurma	å·é¥¼
borx	çº¢èœæ±¤
talon	(æ’é˜Ÿæ—¶å–ç¥¨å«å·çš„)ç¥¨
bjljet	(è½¦ã€å‰§é™¢ç­‰)ç¥¨
naro	é“¶å¸
fero	é“œå¸
taro	é‡‘å¸
kjnka	(æ³›æŒ‡)é’± é‡‘è²¨(ãã‚“ã‹)
kjnkahana	é“¶è¡Œ(é‡‘è²¨ ãã‚“ã‹)+hana
sljvkj	å¥¶çš®å­,é²œå¥¶æ²¹,ä¹³è„‚
lava$	(ç¡¬)è–„é¥¼
kapusta	å·å¿ƒèœ
almagala	å˜å•¦æœ
mandarjnka	æ¡”å­
ananas	è è
mejo	èŠ½,è‹—
meje	æ˜¾éœ²å‡ºè‹—å¤´,æœ‰å¼€å§‹çš„è¿¹è±¡,å‘èŠ½,å‡ºè‹—
kazan	å¤§é”…
far$	é¦…å„¿
mjska	é’µ,ç›† Ğ¼Ğ¸ÑĞºĞ°
hofjnbo	æƒå¨,ä¸“å®¶
pjeroe	ç”¨ç¾½æ¯›æŒ â€¦,ä½¿â€¦å‘ç—’,æŒ ç—’ç—’
pjerowo	ç—’,ç˜™ç—’
brojler	è‚‰é¸¡,è‚‰ç”¨ç¦½ Ğ±Ñ€Ğ¾Ğ¹Ğ»ĞµÑ€
fjlje	é‡Œè„Š,å»éª¨è‚‰
puer	ç”·å­© æ‹‰ä¸è¯­
pole	å……æ»¡,å¡«å……
djepartamjent	éƒ¨é—¨ Ğ´ĞµĞ¿Ğ°Ñ€Ñ‚Ğ°Ğ¼ĞµĞ½Ñ‚
jntonatsja	è¯­æ°” Ğ¸Ğ½Ñ‚Ğ¾Ğ½Ğ°Ñ†Ğ¸Ñ
pjerjebjn	æ¬å®¶
na-	å‰ç¼€,è¡¨ç§¯ç´¯
na@ne	å‡ºç‰ˆ,åˆŠç™»
sanjtar	å«ç”Ÿå‘˜ ÑĞ°Ğ½Ğ¸Ñ‚Ğ°Ñ€
dorogna	çè´µçš„ Ğ´Ğ¾Ñ€Ğ¾Ğ³Ğ¾Ğ¹
dorogtsen@st	çå® Ğ´Ñ€Ğ°Ğ³Ğ¾Ñ†ĞµĞ½Ğ½Ğ¾ÑÑ‚ÑŒ
paluba	ç”²æ¿ Ğ¿Ğ°Ğ»ÑƒĞ±Ğ°
raschjose	æ¢³(å¤´)
elek	ç­›å­
hu$tak	å£å“¨
olcha	æ¨±æ¡ƒ
kajik	å°èˆŸ
sabzi	èƒ¡èåœ
varaq	å•å­
horoz	å…¬é¸¡
zirak	è€³ç¯
chumolj	èš‚èš
zejslae	èµ é€,èµ äºˆ
sinav	è€ƒè¯• sÄ±nav
spjets-	å‰ç¼€,è¡¨ç¤ºâ€œç‰¹åˆ«,ç‰¹æ®Šâ€
spjetsja	é¦™æ–™,è°ƒå‘³æ–™ ÑĞ¿ĞµÑ†Ğ¸Ñ
kor%	(åšæŠ«è¨çš„)è–„é¥¼
bjuzhet	é¢„ç®—
bjuzhet$@	å…¬èŒäººå‘˜
$pon	è–„æ¿,èƒ¶åˆæ¿ ÑˆĞ¿Ğ¾Ğ½
jmpjchmjent	å¼¹åŠ¾
